222222222222222222222222222222
200222222000000222222000022222
200222222000000222222000022222
200220022000000000000002222002
200220022000000000000002222402
200000000002222220022220022002
200000000002222220022220022002
200222222002222220000222200002
200222222002222220000222207002
222222222222200222200000000222
222222222222200222200000000222
222000000222200000000220000222
222000000222200000000220000222
222002200000000220022220000222
222002200000000220022220000222
222002200222222222200222200222
222002200222222222200222200222
222002222222200002222002222222
222002222222200002222002222222
222002222000000000000000022002
222002222000000000600000022002
222002222222222000022220000002
222002222222222000022225000082
222000000222222000022002222222
222000000222222000022002222222
222002200000000000000002222222
222002200000000000000002222222
222002222222222220000000000002
222002222222222220000000000032
222222222222222222222222222222
