022022220000004
000020000222020
222000000222220
200022022200222
222222022002202
000000022000200
200222022220000
200222000020020
200200002020220
220222022020220
020220022000220
000222022022222
202250022222002
200222000000002
022200022222203