1111111111
1000000001
1000000001
1000000001
1000000001
1000000001
1000004001
1000000001
1000000001
1111111111