000000000222222000000222222000000222222000
000000000222222000000222222000000222222000
000000000222222000000222222000000222222000
222000222222222222000000000000222222222000
222008222222222222000000000000222222222000
222000222222222222000000000000222222222000
222000222000000000000222222000000000000000
222000222000000000000222222000000000050000
222000222000000000000222222000000000000000
222000222000222222000222222222222222222222
222000222000222222000222222222222222222222
222000222000222222000222222222222222222222
000000000000222222000000000222222222222222
000000000000222222000000000222222222222222
000000000000222222000000000222222222222222
000222222000222222222222000000000000000000
000222222000222222222222000000000000000000
000222222000222222222222000000000000000000
000222222000222000222000222000222222222000
000222222000222000222000222000222222222000
000222222000222000222000222000222222222000
000222222000000000222222222000222222222000
000222222000000000222222222000222222222000
000222222000000000222222222000222222222000
000000222222222000222000000000000000222222
000000222222222000222000000000000000222222
000000222222222000222000000000000000222222
222000222000222000222222000222222000000000
222000222000222000222222000222222000000000
222000222000222000222222000222222000000000
222000222222000000222000222000000000222222
222000222222000000222000222000000000222222
222000222222000000222000222000000000222222
000000000000222000000222222000222000222222
000000000000222000000222222000222000222222
000000000000222000000222222000222000222222
222000222000222000000000222222222000000000
222000222000222000000000222222222006000000
222000222000222000000000222222222000000000
222000222222000222222000000000222222222000
222007222222000222222000000040222222222003
222000222222000222222000000000222222222000