22222222222222222222222222222222222222222222
20000000002222220000002222220000002222220002
20000000002222220000002222220000002222220002
20000000002222220000002222220000002222220002
22220002222222222220000000000002222222220002
22220082222222222220000000000002222222220002
22220002222222222220000000000002222222220002
22220002220000000000002222220000000000000002
22220002220000000000002222220000000000500002
22220002220000000000002222220000000000000002
22220002220002222220002222222222222222222222
22220002220002222220002222222222222222222222
22220002220002222220002222222222222222222222
20000000000002222220000000002222222222222222
20000000000002222220000000002222222222222222
20000000000002222220000000002222222222222222
20002222220002222222222220000000000000000002
20002222220002222222222220000000000000000002
20002222220002222222222220000000000000000002
20002222220002220002220002220002222222220002
20002222220002220002220002220002222222220002
20002222220002220002220002220002222222220002
20002222220000000002222222220002222222220002
20002222220000000002222222220002222222220002
20002222220000000002222222220002222222220002
20000002222222220002220000000000000002222222
20000002222222220002220000000000000002222222
20000002222222220002220000000000000002222222
22220002220002220002222220002222220000000002
22220002220002220002222220002222220000000002
22220002220002220002222220002222220000000002
22220002222220000002220002220000000002222222
22220002222220000002220002220000000002222222
22220002222220000002220002220000000002222222
20000000000002220000002222220002220002222222
20000000000002220000002222220002220002222222
20000000000002220000002222220002220002222222
22220002220002220000000002222222220000000002
22220002220002220000000002222222220060000002
22220002220002220000000002222222220000000002
22220002222220002222220000000002222222220002
22220072222220002222220000000402222222220032
22220002222220002222220000000002222222220002
22222222222222222222222222222222222222222222
