22222222222222222222
20000002222222222222
20000002222222222222
20022000000000000002
20022000000000000002
20022222200222222002
20022222208222222002
20022222200222222002
20022222200222222002
22222000000000022002
22222000000000022002
22222002222220022002
22222002222220022002
20000002222220022222
20000002222220022222
20022222200000000222
20022222206500700222
20000002222220000002
20040002222220000032
22222222222222222222
