22222222222222222222
20022220022222222002
20022220022222222002
20022000022000000222
20022000022000000222
20000000000002200222
20000000800002200222
22222002222222200222
22222072222222200222
22222002200222200002
22222002200222200002
20000002222002222002
20000002222002222002
20022000000002222002
20022000000002222002
22222002222002222002
22222002222062222402
20022002222000022002
20022002222005022032
22222222222222222222
