22222222222222222222
20022220000222222222
20022220000222222222
20000222200000000002
20000222200000000002
22200000000220022002
22200060000220022402
22200222222220022222
22200222222220022222
22200002222000000222
22200002222000700222
22200002222002200222
22200002222002200222
22200000022002222002
22200000822502222002
22200220000222222222
22200220000222222222
22200222200000000002
22200222200000000032
22222222222222222222
