22222222222222222222
20022222200002222222
20022222200002222222
20000000022220000002
20000000022220000402
22200220000000022002
22200220600000022002
22200222222220022222
22200222222220022222
22200002222220022222
22200002222220022222
22200222200000022002
22200222200080022002
20000222200222222002
25000222207222222002
20022000000002222002
20022000000002222002
20022222222000000002
20022222222000000032
22222222222222222222
