22222222222222222222
20000000000222222222
20000000050222222222
22222220022220000002
22222220022220000002
20022220022002200222
20022220022002200222
22200000000222200222
22200000800222200222
22200222200000000222
22200222200000007222
22200002222000022222
22200002222000622222
20000002222000000002
20000002222000000002
22222002222002222002
22222402222002222002
20022002222002222002
20022002222002222032
22222222222222222222
