22222222222222222222
20022222222222222002
20022222222222222002
20022000000000000222
20022000000000000222
20022220022222200222
20022220022222200222
20000220022222200002
20000220022222200002
22200000000002222002
22200080000002222002
22222002200002200222
22222002200072200222
20000002222002222222
20050002222002222222
20022222222000000002
20022222222060000002
20000000022222222002
20000400022222222032
22222222222222222222
