22222222222222222222
20022002200222200222
20022002200222200222
20022222200000000222
20022222200000000222
20000000000222200222
20000000700222200222
22222220022220000222
22222220022220008222
22222220022220022222
22222220022220622222
20000000022220000002
20000000022220000002
20022220022222200002
20022220022222240002
20022222222002222002
20022222222002222002
20000002222000000002
20000002222500000032
22222222222222222222
