22222222222222222222
20022222222222222222
20022222222222222222
20000000000000000002
20000000000000000002
22200222222222200222
22200222222222200222
22200002222002200222
22200082222072200222
22200002200000000002
22200002200000000502
22222002200222222222
22222002206222222222
20000002200220022002
20000002200220022002
22222002200222222002
22222002200222222002
20022002200000000002
20022002200004000032
22222222222222222222
