22222222222222222222
20022222222000000222
20022222222000000222
20000000022222200222
20000000022222240222
22200220000222200222
22200220006222200222
22200220000222200002
22200220000222200002
22222000000222222002
22222000008222222002
20022002222220022002
20022002222220022002
20000002222220000002
20000002222220000002
20022000000000022002
20022070000000022502
22222002222222222002
22222002222222222032
22222222222222222222
