22222222222222222222
20000222200222200002
20000222200222200002
22200222200220022222
22200222200220022222
22200000000000000002
22200000700000000002
22200222200222222222
22200222200222222222
22200002200000000222
22200002200080050222
22222002222000022222
22222002222000022222
20000002222002222002
20000002222002222002
20022002222002222002
20022402222062222002
22222002222000000002
22222002222000000032
22222222222222222222
