22222222222222222222
20022222222222222002
20022222222222222002
20000000000000022002
20000000000000022002
22222002222220022002
22222062222220022002
22222002200220022002
22222002200220022002
20000000022220000002
20000000022220040002
22222220000222200222
22222225000222207222
22222220022220000222
22222220022220000222
20000000022220022222
20000000022220822222
20000222222000000002
20000222222000000032
22222222222222222222
