22222222222222222222
20022222222220022002
20022222222220022002
20000000000002222002
20000000000002222002
22200222222220000002
22200222222220006002
22200222222000000222
22200222222000050222
20000000000002200222
20000000000002207222
22222002222002222222
22222002222002222222
20000002222002222002
20000082222002222002
22222002222002222002
22222002222002222402
20022002222000000002
20022002222000000032
22222222222222222222
