22222222222222222222
20022220022222222222
20022220022222222222
20022220022000000002
20022220022000000002
20022220022002222002
20022220022002222002
20000220022000022222
20000220022500022222
22200000022220022002
22200000622220722002
22200220022000022222
22200220022000022222
22200220022002222002
22200224022002222002
22200000000000022002
22200000000080022002
20022222222220000002
20022222222220000032
22222222222222222222
