22222222222222222222
20022222222220022222
20022222222220022222
20000000000000000002
20000000000000000002
22222222222000000222
22222222222005007222
22222220022222200222
22222220022222200222
20000000022220000002
20000000022220006002
20022220022222222002
20022220022222222002
20022220022002222002
20022220022002222002
20022220000000000002
20022220008000000002
20000002222222222002
20000402222222222032
22222222222222222222
