22222222222222222222
20000002222000000222
20000002222000000222
22200002222002200222
22200402222002200222
22200222222002222222
22200222222072222222
22200000000002222002
22200000006002222002
22200222222000000002
22200222222000000002
20022222222002222222
20022222222002222222
20022000000000000222
20022080050000000222
20022002222222200222
20022002222222200222
20022002222000000002
20022002222000000032
22222222222222222222
