22222222222222222222
20022222200222222222
20022222200222222222
20000000000220000002
20000000000220000402
20022222222220022222
20022222222220022222
20022002222220000002
20022002222220007002
20000000000000022002
20000080000000022002
22200222222222222002
22200222222222222002
22222222222000000002
22222222222000000002
20000000022002222002
20000005022062222002
22222220000002222002
22222220000002222032
22222222222222222222
