22222222222222222222
20022222222002200002
20022222222002200002
20000000000002222222
25000000000402222222
20022002200220000002
20022002200220006002
22222002222220022222
22222002222220022222
20022000022220000222
20022000022220008222
22200000022222200222
22200000022222200222
22200220000000000222
22200220700000000222
22200222222222200222
22200222222222200222
22200220000220000002
22200220000220000032
22222222222222222222
