22222222222222222222
20000000000222222002
20000000000222222002
20022222222220000222
20022222222220000222
20000222222220000222
20000222222220000222
22200000000000000222
22200070006000000222
22200222222222200222
22200222222222240222
22200220022000022222
22200220022000022222
22200220022222222002
22200220022222222002
22200000000000022002
22200000000000822502
22200222222220000002
22200222222220000032
22222222222222222222
