22222222222222222222
20022222222220000222
20022222222220000222
20000000000000000222
20000000000000000222
20022002222220000222
20022002222220000222
22222000000222200222
22222000800222206222
22200002222220000222
22200002222220000222
22200220022000000002
22200220022000000002
22200222222220022002
22200222222220722402
20000000000222222002
20000000000222222002
22222222200222200002
22222222250222200032
22222222222222222222
