22222222222222222222
20000002222002200222
20000002222002200222
20000002222002200222
20000002222002200222
22222002222000000002
22222062222000000002
20022002222002222222
20022002222072222222
22200000000000000222
22200000000000000222
22200222222002222222
22200222222002222222
22200222200000022002
22200222200080022002
22200002200220000002
22200502200220000402
20022222200222222002
20022222200222222032
22222222222222222222
