22222222222222222222
20000220000000000002
20050220000000000002
22200220022222222002
22200220022222222002
22200000000002222002
22200000000002222002
22200222222002222222
22200222222002222222
22200220022222200002
22200220022222200402
22200222200222222002
22200222200222222002
22200000000000022002
22200080000000722002
22200222200220000002
22200222206220000002
22200222200222222002
22200222200222222032
22222222222222222222
