22222222222222222222
20022222222222222222
20022222222222222222
20000000000000000002
20000000000000000002
22222002222220022222
22222002222220022222
22222002222220000222
22222002222220050222
20000000000222200222
20000000700222200222
20000220000220022222
20000220000220022222
20000222222000022002
24000222222080022002
20000000000000000002
20000000000000006002
22222222222222222002
22222222222222222032
22222222222222222222
