22222222222222222222
20022220022220000222
20022225022224000222
20022220022220000222
20022220022220000222
20022220022220000222
20022220022220000222
20000000022220022002
20000000022220022002
22222220022220022222
22222220022220022222
20022000000000000002
20022000000000700002
22222002222222222002
22222002222222222002
20000002222000000002
20000082222000600002
22222220000002222002
22222220000002222032
22222222222222222222
