22222222222222222222
20022220022222200222
20022220022222200222
20000000000002200222
20000000000002200222
20022220022000000002
20022220022060008002
20022220022222222222
20022220022222222222
20022220000000000222
20022220000000000222
22222220022222200222
22222220022222207222
22200000022220000222
22200005022220000222
22222220022220000002
22222220022220000402
20000000022002222002
20000000022002222032
22222222222222222222
