22222222222222222222
20000002222002200222
20000002222002200222
20022000000222200222
20022000000222200222
20022222222220000002
20022222222220000402
20022222222220022222
20022222222220022222
20000000000000000222
20000000600080000222
22222002222222200222
22222002222222207222
22200000022002200002
22200000022002200002
22200222200222222002
22200222200222222002
22200002222000000002
22200002222005000032
22222222222222222222
