22222222222222222222
20000000000222200222
20000000000222200222
22222222200000000222
22222222200000000222
22222220000222222002
22222220000222222002
20000222200220022002
20000222200220022002
22200000000220022002
22200000000220022002
22200222200000022002
22200222206000022002
22222222222000000222
22222222222000000222
20000000000002200222
20000005000082207222
22222222222222200002
22222222222222240032
22222222222222222222
