22222222222222222222
20000002222000022222
20000002222000022222
22200222222220022002
22200222222220022002
22200000000000000002
22200000800000000002
22200222200222222002
22200222200222222002
22200222200000022222
22200222200000022222
22200222222222222222
22200222222222222222
22200000022002200002
22200000022072200002
22200220000222222002
22250220006222222402
20022220000000000002
20022220000000000032
22222222222222222222
