22222222222222222222
20000002222222222002
20000002222222222002
22200000000000000222
22200000000000050222
22200222222220022222
22200222222220022222
22200222222000000002
22200222222070008002
22200000022002222222
22200000022002222222
20000220022000022222
20000220022060022222
20022220022220000002
20022220022220000002
20022220022220000002
20022220022224000002
20022220022002222002
20022220022002222032
22222222222222222222
