22222222222222222222
20000002222222200222
20000002222222200222
20022222200000000222
20022222200000050222
20000002222220022222
20000002222220022222
20022000022220000002
20022000622220000002
20022220022222222002
20022220022222222002
20022220022000000002
20022220022000000002
20022220000002222222
20022220700002222222
20022220022000022222
24022220022080022222
20022220022220000002
20022220022220000032
22222222222222222222
