22222222222222222222
20022222222222200002
20022222222222200002
20000000000002222002
20000000000002222002
22200222222002222002
22200222222002222002
22200222200002200002
22200222200002200002
20000222200000000222
24000222208000000222
22200002222222200222
22200002222222200222
22200000022220000222
22200000022220700222
22200220022220000002
22200220022220006002
20022220000222222002
20022220050222222032
22222222222222222222
