22222222222222222222
20000002200220000222
20000002200220000222
22200222222220022222
22200222222220022222
22200000000000022002
22200080000000022002
22200222222220000002
22200222222225006002
20000000022222222222
20000000022222222222
22222220000000022222
22222220000000022222
22200220022222222002
22200220722222222002
20000000022222222002
20000000022222222402
22222220000000000002
22222220000000000032
22222222222222222222
