22222222222222222222
20000000022222200002
20000000022222200002
22200222222000022222
22200222222000022222
22200220022220000002
22200220022220008002
22200222200000000222
22200222200070000222
22200000000222200222
22200004000222200222
20000222200222200222
20000222200222200222
22222220000222200222
22222220000222200222
22222220022002200222
22222220022062200222
20000000022002200002
25000000022002200032
22222222222222222222
