22222222222222222222
20000222222220022002
20000222222220022402
22200000000002222002
22200000000002222002
22200222200222200002
22200222200222208002
22200222200002222002
22200222200002222002
22200222200002222002
22250222200072222002
20000002222002222002
20000002222002222002
22222222222002222002
22222222222002222002
22222000000000000002
22222000006000000002
20000000022222222002
20000000022222222032
22222222222222222222
