22222222222222222222
20000222222220000222
20000222222225000222
22200220000222200222
22200220000222200222
22200000022222200222
22200000022222200222
22222220022002200222
22222220022002206222
20022000000000000002
20022080000000000002
20000000022222222002
20000000022222222002
22222220000002222002
22222220000072222002
20000000000222222002
20000000000222222002
22222222222220000002
22222222222220040032
22222222222222222222
