22222222222222222222
20000002200220022222
20000002200220022222
20022002222220022002
20022002222220022002
22222000000220000002
22222000000220000002
22200002200000000222
22200002208000006222
20000222200222200222
20000222200222200222
22200222200222200222
22200222200222200222
22200222200222222002
22200222200222222002
22200222200220022222
22200222200220722222
22200002200000000002
22200502200400000032
22222222222222222222
