22222222222222222222
20000000022002222222
20000000022002222222
22200220022220000002
22200220022220000002
22200220000220022002
22200220800224022002
22200222200002222002
22200222200062222002
22200002222002222002
22200002222002222002
20022002222002222002
20022502222072222002
22222002222000000002
22222002222000000002
20000002200002222002
20000002200002222002
22222222200002222002
22222222200002222032
22222222222222222222
