22222222222222222222
20000222222222200002
20000222222222200002
22200000000000000002
22200000000000000502
22200222222002222222
22200222222002222222
22200222222000000222
22200222222000000222
22200000000222222222
22200000000222222222
22200222222002200002
22200222222002200002
22200220022222222002
22200220022222222002
22200000022000000002
22200000722064008002
20022220000002222002
20022220000002222032
22222222222222222222
