22222222222222222222
20000000000222200222
20000000000222240222
22200222222220000222
22200222222220000222
22200222222220022002
22200222222220022002
20000000000000022222
20000000000000022222
22222002222002222002
22222002222072222002
22200002222002222002
22200002222002222002
22200220000000022002
22200220050000622002
22200222222000000002
22200222222000008002
22200220022002222002
22200220022002222032
22222222222222222222
