22222222222222222222
20000000000000000222
20000000000500000222
22200222222222200222
22200222222222200222
22200222222222222002
22200222222222222002
22200220000000000222
22200220700000000222
22200000022222222222
22200000022222222222
22200220022222222002
22200220022222222002
20022220022000000002
24022220022000800002
20000000022002222222
20000000022062222222
22222220000000000002
22222220000000000032
22222222222222222222
