22222222222222222222
20022222222220000222
20022222222220040222
20022000000000022222
20022000000000022222
20000002222222222002
20000072222222222502
20000222222220000002
20000222222220000002
20000000000000022222
20000000000000022222
22222222222000000222
22222222222000000222
20022002222002200222
20022062222002208222
22200000000002200222
22200000000002200222
22200222222222200002
22200222222222200032
22222222222222222222
