22222222222222222222
20000002222222222002
20000002222222222002
22200222200000000222
22200222200000000222
22200000000222200222
22200000800222200222
20000002200222200002
20000002200222200402
20022002222002222222
20022002222002222222
22222000022220022222
22222000622220022222
22222220022220022002
22222220022220022002
20000000022000000002
20000000022000750002
22222220000002222002
22222220000002222032
22222222222222222222
