22222222222222222222
20022220022222200002
20022220022222200002
20022220000000022222
20022220040000022222
20022222222220022002
20022222222220622002
20000002222000000002
20000002222070000002
22222002222002222222
22222002222002222222
22200002200002222002
22200002250002222002
22200222200000000222
22200222200000000222
22200222200222200222
22200222200222208222
22200000000002200002
22200000000002200032
22222222222222222222
