22222222222222222222
20000222200000000222
20000222200000000222
22200000000222222222
22200000000222222222
22200002222220022002
22240002222220022002
20000222222220000002
20000222222220050002
22200000000000000002
22200000006000000002
22200002222222222222
22200002222222222222
22222002222222222222
22222002222222222222
20000000000000000002
20000080000000700002
22222222222002222002
22222222222002222032
22222222222222222222
