22222222222222222222
20000002222000022222
20050002222000022222
22200002222220022002
22200002222220022402
22200222200000022002
22200222200000622002
22200222200222222002
22200222200222222002
22200222200000022002
22200222207000022002
20000002222000000002
20000002222000000002
22222002222002222002
22222002222082222002
22200000000002222002
22200000000002222002
22200222222002222002
22200222222002222032
22222222222222222222
