22222222222222222222
20022220000002222222
20022220000002222222
20022220022000000002
20022220022000000002
20000000022222222222
20000000022222222222
22222002222000022222
22222082222000022222
22200000000000000002
22200000600000000002
22200222222000022222
22200222222000022222
22200220022220022222
22200220022220722222
22200222200000000002
22200222200400000502
20000002222222222002
20000002222222222032
22222222222222222222
