22222222222222222222
20022222222000000002
20022222222000000002
20000000000000000002
20000000000000000002
22222002222222200222
22222002222222200222
20022000000222200222
20022000650222200222
22222222200222200222
22222222200222200222
20000000000222200222
20000000000222200222
20022222200222200222
20022222208222207222
20022222200220000002
20022222200220040002
22222000000222222002
22222000000222222032
22222222222222222222
