22222222222222222222
20022220022222200222
20022220022222200222
20000220022002200222
20000220022002200222
20000220000000000222
20000220000500000222
22200000022222200222
22200004022222200222
22222002200222200222
22222072200222208222
20000002200222200222
20000002200222200222
22222000000222222222
22222000000222222222
22200000000000022002
22200000000000622002
22200222222220000002
22200222222220000032
22222222222222222222
