22222222222222222222
20000000022002200222
20000000022002200222
22200222222222200222
22200222222222200222
22200000000000000222
22200070000000000222
22200220022222200222
22200220022222200222
20000222222220000222
20000222222220000222
22222222200000000222
22222222200000000222
22200002200222200222
22200402208222200222
22222000000222200222
22222000000222206222
20000000022220000002
20050000022220000032
22222222222222222222
