22222222222222222222
20000000000222222002
20000000000222222002
22200002222220000222
22200002222220000222
22200000022222200222
22200000022222200222
22200220022000000222
22200225022000000222
22200220000000000222
22200220000000007222
22200222200220022002
22240222200220622002
22200222200220022222
22200222200220022222
22200222200220000002
22200222208220000002
22200222200222200002
22200222200222200032
22222222222222222222
