22222222222222222222
20000222222222200222
20000222222222200222
22200000000000000222
22200000000000000222
22200222200222200222
22200222206222250222
20000222200002200222
20000222200002200222
20022220000000022222
20022220000070022222
20000220000222222002
20000220008222222002
22200222200002222002
22200222200002222002
22200222200222222002
22240222200222222002
22200222200000000002
22200222200000000032
22222222222222222222
