22222222222222222222
20022222222220022222
20022222222220022222
20000000000002200002
20000000000002240002
20022220022222200222
20022220622222200222
20022220022220000222
20022220022220800222
20022220000000022222
20022220000000022222
20022220022220000002
20022220022220000002
20022220000222222222
20022220000222222222
22222222200000000002
22222222200070000002
20000000000222222002
25000000000222222032
22222222222222222222
