22222222222222222222
20022222222220022002
20022222222220022002
20000000000220022002
20000000000220022002
22222222200220022222
22222222200220022222
22200222200000022002
22200222200000022002
22200222200220000002
22200222208220006002
22200000000220022222
22200070000220022222
20000220022000000222
20000220022400000222
22200222222002222222
22200222222002222222
22200222200000000002
22250222200000000032
22222222222222222222
