22222222222222222222
20022222222220022002
20022222222220022002
20000000000002222002
20000000000002222502
20022220022222222002
20022220022222222002
20022220000220022002
20022220000220022002
20022220000000000002
20022220000000600002
20022220000002200222
20022220040002200222
20022222222222200222
20022222222222200222
20000000000222200222
20000070008222200222
22222222222220000002
22222222222220000032
22222222222222222222
