22222222222222222222
20022220000000000222
20022220000000000222
20022220022222200222
20022220022222200222
20000000022220000222
20000000022220000222
22222220022220000222
22222220722225000222
22200220022222200222
22200220022222200222
22200000000000022222
22200000800000022222
22200220022220000002
22200220022220006002
20000222222222222002
20000222222222222402
22222220000000000002
22222220000000000032
22222222222222222222
