22222222222222222222
20022222200002222222
20022222200002222222
20000002222002200002
20000002222002200002
20022000000000000222
20022000000000008222
20022002200222200222
20022072200222200222
22222002200222200222
22222002200222200222
22222222200222200222
22222222206222200222
20000000000222200002
20000000000222240002
20022222200222222002
20022222200222222002
20022002200000022002
20022002200005022032
22222222222222222222
