22222222222222222222
20000222200000000002
20000222200000000402
20000222200222222222
20000222200222222222
20000222200002222222
20000222200072222222
22200222222000000002
22200222222000000002
22200000000002222002
22200000000062222002
22200222222002222002
22200222222002222002
22200222222000022222
22250222222000822222
20000220022220022222
20000220022220022222
22222220000000000002
22222220000000000032
22222222222222222222
