22222222222222222222
20022222200000022222
20022222200004022222
20000000000222222002
20000000000222222002
20022222200002222002
20022222200002222002
22222220000002222002
22222220600002222002
22200000022000000002
22200070022000008002
20022220022222222222
20022220022222222222
20022220022222222222
20022220022222222222
22200220000000000002
22200220000005000002
22200000022222200002
22200000022222200032
22222222222222222222
