22222222222222222222
20022002222222200002
20022002222222200002
20022220000000022222
20022220000000022222
20000000022220000002
20000000022220000002
22222222222222222002
22222222222222222002
22200220000000000002
22200220000000700002
20022002222002200222
20022082222062200222
20022222222002200222
20022222222002200222
20000000000002200222
20000000000002250222
22222222200222200002
22222222240222200032
22222222222222222222
