22222222222222222222
20022222222222222222
20022222222222222222
20000000000000000002
20000000000000000002
22200002222002222222
22200002222002222222
22200002222222222222
22200062222222222222
22200000000000000002
22200000800000700002
20022222200220000002
20022222200220000002
22200222200222222002
22200222200222222002
22200000000222200002
22240000000222250002
22200222200222200002
22200222200222200032
22222222222222222222
