22222222222222222222
20000002222002222002
20000002222002222402
22200222200000000002
22200222200000000002
22200222200220000222
22200222200225000222
22200222200222200222
22200222200222208222
22200222200220022222
22200222200220022222
22200000000222222002
22200000000222222002
22200222222000000002
22200222222000000002
22200000000000022222
22200000600000722222
22200222222220000002
22200222222220000032
22222222222222222222
