22222222222222222222
20022222222000022222
20022222222000022222
20000000000002222002
20000000000002222002
22200222222002222002
22200222222002222002
22200220022000000002
22200220022000007002
22200222200002200222
22200222200002200222
22222220000222200222
22222220600222200222
20000000000222200002
20000080000222200002
22200222222222222002
22200222222222222002
22200002222000000002
22250002222000040032
22222222222222222222
