22222222222222222222
20022222222000000002
20022222222000000002
20000000022002222222
20000000022002222222
20022220000000000222
20022220006000800222
20022002222222200222
20022002222222240222
20000222222222200222
20000222222222207222
20000000000002222222
20000000000002222222
22200222222002222002
22200222222002222002
22200222222222222002
22200222222222222502
22200000000000000002
22200000000000000032
22222222222222222222
