22222222222222222222
20022220022220000002
20022220022220000002
20022220022220022222
20022220022220022222
20000000000000000222
20000000000000006222
20000222222222200222
20000222222222200222
22222222222222200222
22222222222222200222
20000000000000000222
20000070000000000222
22222002222220022222
22222002222220022222
22222002222220000002
22222002222220840002
20000000000002222002
20000000000502222032
22222222222222222222
