22222222222222222222
20000222222222222222
20000222222222222222
22200220000000000002
22200220000000000002
22200000000002222222
22200000000002222222
22200222222000022002
22200222222000822002
22200220000220000222
22200220000220000222
22200222222222200222
22200222222222207222
22200000000002200002
22200000000002200002
20000222200222222002
20000222206222222502
22222220000000022002
22222220040000022032
22222222222222222222
