22222222222222222222
20022222200000000222
20022222200000000222
20000000000222222222
20000000000222222222
22222002222222222002
22222002222222222002
22222002200000000002
22222002200400000502
20022000000222222222
20022070008222222222
20000002222222222002
20000002222222222002
22200222200000000222
22200222200060000222
22200220000002200222
22200220000002200222
22200000022222200002
22200000022222200032
22222222222222222222
