22222222222222222222
20022222200222200222
20022222200222200222
20000000000222200222
20000000000222200222
22222000000222200002
22222060008222240002
22222002200002222002
22222002200002222002
20000002222000000002
20000002222000007002
22222002222000000222
22222002222000000222
22222002222222200222
22222002222222200222
20000000000002200002
20000000000002200002
22222222222002222002
22222222222502222032
22222222222222222222
