22222222222222222222
20000002222000000222
20000002222000000222
22222000022222200222
22222000022222200222
20022000022222200222
20022000022222206222
20022220022000000222
20022220022080000222
22200000022002200002
22200000022002200002
22200220022002222002
22200220022002222002
22200220000002222002
22200220000072222402
22200220022002222002
22200220022002222002
20022220022222200002
20022220022222250032
22222222222222222222
