22222222222222222222
20022222222000022002
20022222222000022002
20000000022220022002
20000000022220022002
22222002222220022002
22222002222220022002
20000000000000000222
20000060000000000222
22222222222222200222
22222222222222208222
22222222200222200222
22222222207222200222
20000000000000000222
20000000000000000222
20022002200220022222
20022002200220022222
22222002222220000002
22222402222220050032
22222222222222222222
