22222222222222222222
20000002222222222222
20000502222222222222
22222000000000000002
22222000000000000002
22222222222002222222
22222222222002222222
20000000000002222222
20000060007002222222
20000222222222200002
20000222222222200002
20000222222220000002
20000222222220000002
22200000000000022002
22200000000080022002
22200222222222222002
22200222222222222002
22200000000222200002
22200400000222200032
22222222222222222222
