22222222222222222222
20000000000000000222
20000000000000000222
22200222200222222222
22200222250222222222
22200222200002222002
22200222200002222002
22200002222002222002
22200002222072222002
20022002200000000002
20022402206000008002
22222222200222222002
22222222200222222002
20000222200222222002
20000222200222222002
22200000000220000002
22200000000220000002
22200222200222222002
22200222200222222032
22222222222222222222
