22222222222222222222
20000002222220000222
20000002222220000222
22200000000000000222
22200000000000000222
22200220022222222222
22200220622222222222
22200220000002222002
22200220000002222502
22200002222222222002
22200002222222222002
22200000000000000002
22200000000000000002
22222220022002222002
22222220022002222002
20000000022002222002
20000070022082222402
22222222222002222002
22222222222002222032
22222222222222222222
