22222222222222222222
20022222222000000002
20022222222000000002
20000000000000022222
20000000000000022222
22222220022220000002
22222220822220050002
22200000022220022222
22200000022220022222
22200220022220000222
22200220022220700222
22200220000220000222
22200220000220006222
22200222222002200222
22200222222002200222
20000002222222200222
20000002222222200222
22222222200000000002
22222222200000040032
22222222222222222222
