22222222222222222222
20000222200000022222
20000222200000022222
22200222222220000002
22200222222220000002
22200000022220022002
22200000722220022002
22222000022220022222
22222000022220022222
20022220022000000222
25022220022000000222
20000000000002200222
20000000000062208222
22222222222002200222
22222222222002200222
22222220000002200222
22222220000002200222
20000000022222200002
24000000022222200032
22222222222222222222
