22222222222222222222
20000222222222222222
20000222222222222222
22200220000000000002
22200225000000000002
22200222222000022222
22200222222000022222
20000002222000022002
20000002222000822002
20022002222220022222
20022002222220022222
22222002200000000002
22222002200070000002
20022002222220022002
20022002222220022402
20022000000000022002
20022000006000022002
20000222222222222002
20000222222222222032
22222222222222222222
