22222222222222222222
20022222222222200222
20022222222222200222
20000000000002200222
20000000000002200222
20022002222000000222
25022002222000000222
22222002222002200222
22222002222002200222
22222002200222200222
22222002200222200222
20022000000222200002
20022000000222200002
20000002200002222222
20040082207002222222
20022222222000000002
20022222222000600002
20022220000002222002
20022220000002222032
22222222222222222222
