22222222222222222222
20022222222222200222
20022222222222200222
20000000000002200222
20000000000002240222
20022222222000000222
20022222222000007222
20000222222002200222
20000222222062200222
20022220022222200002
20022220022222200002
20022220022220022222
20022220022220022222
20022000000000000222
20022000000000000222
20022002222002200002
20022002222082200002
20000002222002222002
20050002222002222032
22222222222222222222
