22222222222222222222
20022220022002222002
20022220022002222002
20022220022220000222
20022220022220000222
20000000022222200222
20000000022222200222
20000000000000000222
20000000008000000222
22200222222222222222
22200222222222222222
22200222222220000002
22200222222220007502
22200000000220022222
22200000006220022222
20000002200220022222
20000002200220022222
22222222200000000002
22222222240000000032
22222222222222222222
