22222222222222222222
20022220000000000002
20022220000000000502
20022222222002222222
20022222222002222222
20000002222002200222
20000002222002200222
20022220022000000222
20022220622400000222
20000222222222200222
20000222222222208222
22200000000000000222
22200000007000000222
22222002222222200222
22222002222222200222
20000000000220000002
20000000000220000002
22222222222002222002
22222222222002222032
22222222222222222222
