22222222222222222222
20000222222000000002
20000222222000000002
22200000000000000222
22200000000000000222
22200222222000000222
22200222222000800222
22200222200002222222
22200222200062222222
22200222200222222002
22200222200222222002
22200222200000000002
22200222200075000002
20000222200222222222
20000222200222222222
20022222200222222222
20022222200222222222
22222000000000000002
22222000000004000032
22222222222222222222
