22222222222222222222
20022222222000022002
20022222222000022002
20000000000002222222
20000000000002222222
20022220000222200002
20022220000222200002
20022002200222200222
20022002200222207222
20000222200222200222
20000222200222200222
20022220000222200222
20022220000222206222
22222220000222200222
22222220000222200222
22200222200222200222
22200222208222240222
22200000000000000002
22250000000000000032
22222222222222222222
