22222222222222222222
20022222200222222002
20022222200222222002
20022000000000000222
20022000000000000222
20000002222002200222
20000002222002250222
22222000022222200222
22222000022222206222
20022000022222222222
20022000022222222222
22222220022000000002
22222220022000800002
20000000000002222002
20000000000002222002
20022220022002222002
20022220722002222402
20022002222002222002
20022002222002222032
22222222222222222222
