22222222222222222222
20000222200222200222
20000222200222240222
20022002200222200222
20022002200222200222
20022002200220000222
20022002200220800222
20022222200000022002
20022222200060022002
20000002222220022002
20000072222220022002
22200002200220000222
22250002200220000222
22200002222220022222
22200002222220022222
20000000000000000002
20000000000000000002
22222222222222222002
22222222222222222032
22222222222222222222
