22222222222222222222
20022220000002222002
20022220000502222002
20000220022222200222
20000220022222200222
22200220000000000222
22200220000000700222
22200000000222200222
22200080000222200222
22200220022220000222
22200220022220000222
22200222222220000222
22200222222220000222
22200222200000000222
22200222200000006222
22200222200220000222
22200222200220000222
22200002200222200002
22200002240222200032
22222222222222222222
