22222222222222222222
20000002200220022002
20000002200220022502
22200222200222222002
22200222200222222002
22200000000000000002
22200000000000000002
20000222222222200222
20000222222222200222
22222222222222200222
22222222222222200222
22222000000002200222
22222004000002208222
20022002222000000222
20022002222000000222
20022002222002222222
20022072222062222222
20000002222000000002
20000002222000000032
22222222222222222222
