22222222222222222222
20022222222222222222
20022222222222222222
20022000000000000002
20022000000000000002
20000002222220022002
20000002222220022002
20000002222220022222
20050002222220822222
20022222200000022002
20022222200000022002
22222222200002222222
22222222200002222222
22200002222002200002
22200002222002200002
20000000000000000002
20000400000070006002
22222220022222222002
22222220022222222032
22222222222222222222
