22222222222222222222
20000002222000000002
20000002222000000002
22222002222002222222
22222002222002222222
22200000000002222222
22200000000002222222
22200000022222200002
22200000022222240002
22200220000222200222
22200220600222200222
22200220000002200222
22200220000002200222
22222220022000000222
22222220022000700222
20000000022002200222
20050080022002200222
22222220022222200002
22222220022222200032
22222222222222222222
