22222222222222222222
20000000000222222222
20000000000222222222
20022222200000000002
20022222200000000002
20000002200222222222
25000082206222222222
22222222200222222222
22222222200222222222
22200222200000000002
22200222200000000002
22200222200222222002
22200222200222222002
20000000000000022002
20000000007000022002
22200222222220022002
22200222222220022402
22200000022220022002
22200000022220022032
22222222222222222222
