22222222222222222222
20000000000002200002
20000005000002200002
22200222222222222002
22200222222222222002
22200222222220000222
22200222222224000222
22200220000222200222
22200220000222200222
22200222200220000222
22200222200220000222
22200222200000000222
22200222200000008222
22200000000002200222
22200000007002200222
22200220000002200222
22200220000002206222
22200222222220000002
22200222222220000032
22222222222222222222
