22222222222222222222
20022000022222222222
20022005022222222222
20022000022000000002
20022000022000000002
20022000022222222002
20022000022222222402
20000002222222222002
20000002222222222002
22200000000000000002
22200080000000000002
22200222222002200222
22200222222002207222
22200002222222200222
22200062222222200222
22200222200222200222
22200222200222200222
22200000000222200002
22200000000222200032
22222222222222222222
