22222222222222222222
20022220022220000222
20022220022220000222
20000000022222200222
20000000022222200222
22222002222000000222
22222002222000000222
20000002222220022222
20000002222220622222
20022000000000000002
20022000000070000002
20022220022220022222
20022220022220022222
20022220022220000002
20022220822220000002
22222220022220022002
22222220022220022402
22200000022220022002
22200000022225022032
22222222222222222222
