22222222222222222222
20022220000222222222
20022220000222222222
20000000000000000002
20000000000000000002
22222002222220022002
22222082222225022002
22200002200220022002
22200002200220022002
22200002222220022002
22200002222220622002
22200002200222200222
22200002200222200222
22200222200222222222
22200222207222222222
22200222200000000002
22200222240000000002
22200000000222222002
22200000000222222032
22222222222222222222
