22222222222222222222
20022220022222200222
20022220022222200222
20000002200002200222
20000002200002240222
22200002200222200222
22200002200222200222
22200000000220000222
22200000000220000222
22200220022220022222
22200220022220722222
22200220022220022002
22250220022220022002
22200220022000000002
22200220022000800002
22200220000002222222
22200220006002222222
22200222222000000002
22200222222000000032
22222222222222222222
