22222222222222222222
20000000000222200222
20000000000222200222
22200222200222200222
22200222200222200222
22200222200220000222
22200222200220000222
20022222200000022002
20022222200070022002
20022000000220022222
20022000000220822222
20022222222220022002
20022222222220022002
22200222222220022002
22200222222220022402
22200000000000000002
22200000000000006002
22200222222220000002
22200222222220050032
22222222222222222222
