22222222222222222222
20000222200222222002
20000222200222222002
22200222200000000222
22200222200000000222
22200220022220000222
22200220022220000222
20000222222000000222
20000222222000000222
20022220022002200002
20022220022002250002
20022220000002222002
20022220800002222002
20022222222000022002
20022222222000022002
20000000000000022002
20000000006000722402
22222222222222222002
22222222222222222032
22222222222222222222
