22222222222222222222
20000000000222222002
20000000000222222002
22200222222220000222
22200222222220000222
22200220000222200222
22200220008222240222
22200220000222200222
22200220000222200222
22200000000222200222
22200070006222200222
22200222200222200222
22200222200222200222
20000220000000000222
20000220000000000222
22222222222220022222
22222222222220022222
22200000000000000002
22200000000000050032
22222222222222222222
