22222222222222222222
20022222200220022222
20022222200220022222
20000002200222200002
20000002200222200002
22222000000220000222
22222000000220000222
22200002200220022222
22200002200220022222
22200222200000000002
22200222200000008002
20000222200220022002
24000222207220022002
22200222222220022002
22200222222220622002
22200000022222222002
22200000022222222002
20022220000002222002
20022220050002222032
22222222222222222222
