22222222222222222222
20000002222002222002
20000002222002222002
22222002222002200222
22222002222002240222
22222002222002200222
22222002222002200222
20022002222000000222
20022082222060000222
20022002222220000222
20022002222220000222
20000000000000000222
20000000000000000222
22200002222222200222
22200072222222200222
22200002222000000222
22200002222000000222
22200002200222200002
22250002200222200032
22222222222222222222
