22222222222222222222
20000222222000022002
20000222222000022002
20022220022002222222
20022225022002222222
20022220000002200002
20022220008002200002
20022222222002200222
20022222222062200222
20022002222002200222
20022002222002200222
20022000000000000222
20022000000000007222
20000002222222200222
20000002222222200222
22222002222220000222
22222002222220040222
20022000000222200002
20022000000222200032
22222222222222222222
