22222222222222222222
20000002222000022002
20000002222000022002
22222000022220022002
22222000022220022002
22200000022220022002
22200000022220722002
22200220000000022222
22200220000080022222
22200222200220022002
22250222206220022002
22200222200220000002
22200222200220000002
22200222200222222222
22200222200222222222
22200222200220000222
22200222200224000222
22200222200000000002
22200222200000000032
22222222222222222222
