22222222222222222222
20022222200002222222
20022222200002222222
20000002200222200002
20000002250222200002
22222000000222200222
22222060000222200222
22222002200000000222
22222002200000008222
20000002222002200002
20000402222002200002
22222222222002222002
22222222222002222002
22200000000002222002
22200000000002222002
22200220022222222002
22200220722222222002
20022220000000022002
20022220000000022032
22222222222222222222
