222222222222222222222222
200222222222200220000002
200222222222200220000002
200000000000000222222222
200000000000007222222222
222222200220000000000002
222222200220000000000002
200222200222222002222222
200222200222222002222222
222002200222200002222002
222002200222200002222002
222002200220022000000222
222502200220022000000222
200000000222222002222222
200000800222222002222222
200222222220000000000002
200222222220000000000002
200002200000022222222222
200002200000622222222222
222002222220000000000002
222002222220000000000002
222000022220022222222002
222400022220022222222032
222222222222222222222222
