222222222222222222222222
200002200222222222200002
200002200222222222200002
222002222000000000022002
222002222000000000022002
222002222002222220022222
222002222002222220022222
200000000002222220000002
200000000002222225000002
222222200000000222222222
222222200000000222222222
222000000222200222200222
222000700222200222200222
222002200222200000000222
222002208222200000040222
200002222222200222200222
200002222222200222200222
222222222000000222200222
222222222000000222200222
222000000002200222200222
222000000002200222206222
222002222222200222200002
222002222222200222200032
222222222222222222222222
