222222222222222222222222
200000000222200222222222
200000000222200222222222
200002200222200000000002
200002200222200000040002
222222200222222220022002
222222200222222220022002
222222200000022220022222
222222200000622220022222
200002222220022220022222
200002222220022220022222
200222200220022220022002
200222200220022220022002
200220022000022220000002
200220022070022220800002
200000022002200000022002
200000022002200000022002
200220000002200222222002
200220000002200222222002
200222222000000002222002
200222222000000002222002
200002222002222002222002
250002222002222002222032
222222222222222222222222
