222222222222222222222222
200222222220000002200222
200222222220000002200222
200000000000022222200222
200000008000022222206222
200222200220022222200222
200222200220022222200222
200222200222222000000222
250222200222222004000222
200222200222200000000002
200222200222200000000002
200222200002200222200002
200222200002200222200002
222220022000000222200222
222220022000000222200222
222002222002222220000222
222002222002222220000222
222000000000022000022002
222000000000022000022002
222002200222222002222222
222002200222222002222222
222002200220022000000002
222002200220022000700032
222222222222222222222222
