222222222222222222222222
200002222222200002222002
200002222222200002222002
200000000002200222222002
200000000002200222222002
222000000222200000022002
222000000222200000022002
222002200220022220000002
222002200220022220000002
222002200222222220022222
222002200222222220022222
222002200000000000000222
222002206000007000000222
222222222002222002200222
222222222002222082200222
200000000002222222200222
200500000002222222200222
222222222000000222200222
222222222000000222200222
222222222222200222200002
222222222222200222200402
200000000000000222200002
200000000000000222200032
222222222222222222222222
