222222222222222222222222
200222222220022002222002
200222222220022002222002
200000000000022220000222
200000000000022220000222
200222200220000002200222
250222200220000002200222
222222200222222222200222
222222200222222222200222
200000000000000222200222
200000000000800222200222
200220022002222220000002
200220022002222220006002
200222222000022222200222
200222222000022222200222
200222200000000000000222
200222200000000000700222
222222222220000220000222
222222222220000220000222
222000000000022220022222
222000000000022220022222
222002222222222000000002
222002222222222400000032
222222222222222222222222
