222222222222222222222222
200222200222200000000222
200222200222200000000222
200000000000000222200222
250000000000000222200222
200220000220022222200222
200220000220822222200222
222222200220022000000002
222222200220022000000002
222002222002222002222222
222002222002222062222222
222002222222222002222222
222002222222222002222222
200000000000000000000002
240000000000000000000002
200222200222222222222002
200222200222222222222002
222220000002222222222002
222220000002222222222002
222222222002200000022002
222222222002200070022002
200000000002222220000002
200000000002222220000032
222222222222222222222222
