222222222222222222222222
200000000000000222200222
200000000000000222200222
222002222222200222200222
222002222222200222200222
222002222220000000000002
222002222220800000000002
222000000220000222222222
222000050220000222222222
200002200220022002200222
200002200220022002200222
222002222220022000000222
222002222220022000007222
222000022220000002200222
222000022220000002200222
222222222000000222200222
222222222000000222200222
200220022002200222200222
200220022062200222200222
200000000002222002200222
240000000002222002200222
222222222000022220000002
222222222000022220000032
222222222222222222222222
