222222222222222222222222
200000000000022002222222
200000000000022002222222
222222222220022220000002
222222222220022224000002
222222200000000000022002
222222200000000080022002
200002200222222220022222
200002206222222220022222
222000000000022220022002
222000000000022220022002
222000022222200220022222
222000022222200220722222
222000022222222000000002
222000022222222000000002
222002222000022002222002
222002222005022002222002
222000000220022002222002
222000000220022002222002
222002200220022002222002
222002200220022002222002
222002200000022002222002
222002200000022002222032
222222222222222222222222
