222222222222222222222222
200002200222200222200002
200002200222200222200002
222002222000000220022002
222002222000000224022002
222002222002222220022002
222002222002222220022002
222000000002200000022222
222000000002200000022222
222002222222200220000002
222002222222200220000002
222000000222200222200222
222000000222250222200222
222002200000000220022222
222002200000700220822222
222002222222200222222002
222002222222200222222002
200002222002200000022002
200002222002200060022002
222000000222200220022002
222000000222200220022002
222002222220000220000002
222002222220000220000032
222222222222222222222222
