222222222222222222222222
200222222222200222222222
200222222222200222222222
200000000000000220000002
200000000000000220000002
200222200002200222222002
200222200002200222222002
222220000222200002200002
222220000222206002200502
222000022002222000000222
222000022002222080000222
222002222220022222200222
222002222220022222200222
222002200000000002200002
222002200000000002200002
222002222222222000000002
222002222222222000700002
222222222222222220000002
222222222222222220000002
200000000000000000000002
240000000000000000000002
222222222222222222200002
222222222222222222200032
222222222222222222222222
