222222222222222222222222
200222222222200222222222
200222222222200222222222
200000000000000220000002
200000000000000224000002
200222200222222220022002
200222200222222220022002
200222200002222222222002
200222200002222222222002
200002222222200000022002
200002222222200000022002
222002222222200220000002
222002222222200220800002
222000000002222220022222
222000000002222220022222
200002222000022220000222
200002222000022220000222
200222200220022220022222
200222206220722220022222
200220022220022000022002
200220022220022000022002
200000022220000000000002
200005022220000000000032
222222222222222222222222
