222222222222222222222222
200000000220000002222002
200500000220000002222002
222222200220022222200222
222222200220022222200222
222220000000000002200222
222220000000000402200222
200000000222200222200222
200000000222200222200222
222222200002222220000222
222222200002222220000222
222222222002222220022222
222222222002222220022222
200000000000000000000002
200000700000000000000002
200222222222200222200222
200222222222200222200222
200222200000000222200222
200222206000000222200222
200222222220022220000002
200222222220022220000002
200000022220000222222002
200080022220000222222032
222222222222222222222222
