222222222222222222222222
200222222000022222200002
200222222000022222200002
200000000222200000000222
200000000222200000000222
222002222220000222200222
222002222220600222200222
222000000222222002200222
222000000222222002200222
200002222000000222200222
200002222000000222207222
200000000002200002200222
200000000002200002200222
200222222222200000000222
200222222222200000000222
200000022002200222200222
200000022082200222200222
200222222222200222200222
200222222222200222200222
200002200000000222200222
200002240000000222200222
222222200222200222200002
222222200222250222200032
222222222222222222222222
