222222222222222222222222
200220022220022220000002
200220022220022220000402
200222200000022220022002
200222200000022220022002
200222222002222000022222
200222222002222000022222
200000000000000002200222
200000000000000002200222
222002222000022222200222
222002222000022222200222
222002222220000220000222
222002222220006220000222
222002200000000222200222
222002200000000222200222
222002222220022220000222
222002222220822220000222
222002200220022000022222
222002200220022070022222
200002222000000000000002
250002222000000000000002
222220000222222222222002
222220000222222222222032
222222222222222222222222
