222222222222222222222222
200222222222200000000002
200222222222200000000002
200000000000000222222002
200000000000000222222002
200222200220022220022002
200222200220822220022002
222222200220000220000002
222222200220000220000002
222000000222200222222222
222000000222200222222222
222222200222200222200222
222222200222250222200222
200000000222222000000222
200000000222222000000222
222220022220022222200222
222220722220022222200222
222220000000000222200222
222220000000000222200222
200222222002200000000222
200222222002200000006222
200000000002222222200002
200000000002222222240032
222222222222222222222222
