222222222222222222222222
200222222222222222222002
200222222222222222222002
200000000000000000000222
200000000000000000700222
200220022222222002200222
200220022222222002200222
200220022000022222200222
200220022000022222240222
200220000002222222200222
200220000002222222200222
200220000222200000022002
200220008222200005022002
222222200222200220022002
222222200222206220022002
222000000000000222222002
222000000000000222222002
222002222222200222200222
222002222222200222200222
200222200000000000000222
200222200000000000000222
200220000222200222200002
200220000222200222200032
222222222222222222222222
