222222222222222222222222
200002222222222222222222
200002222222222222222222
200222200000000000000002
200222200070000000000002
200000000222222222222002
200080000222222222222002
222220000220022220000002
222220000220022220000002
200000000000022220022002
200000000000022220022002
200222200222222222222002
200222206222222222222002
222222200222200002222002
222222200222200002222002
222000000220000220000002
222000000220050220000002
222002200220022220022222
222002200220022220022222
222002200220000220022222
222002200220000220022222
222002200222200000000002
222002200222200400000032
222222222222222222222222
