222222222222222222222222
200000000000022002200002
200000000000022402200002
222002222222222002222002
222072222222222002222002
222002222222200000000222
222002222222200000000222
222002200002200222222222
222002200082200222222222
222000000222200222222002
222000000222200222222002
222000022220000000022002
222000022220000000022002
222000000000022220000002
222000000000022220000002
222002200220022220022002
222002206220022220022002
222002200220022220022222
222002200220022220022222
222002222220000220000222
222002222225000220000222
222002200002222220000002
222002200002222220000032
222222222222222222222222
