222222222222222222222222
200002222002200000000222
200002222002200000000222
200222200222200222222222
200222200222200222222222
200220000000000220022002
200220000000000220022002
200000022002200002222002
200000622002200002222502
222222222002222220022002
222222222002222220022002
222222222002222222200002
222222222002222222200002
200000000000000000000002
200000000000000000000002
200222222220022222222002
200222222220722222222002
200222222000022002222222
200222222000022002222222
200000022000000000000222
200000022000800000000222
222222222002222222200002
222222222402222222200032
222222222222222222222222
