222222222222222222222222
200222222222200002222002
200222222222200002222002
200000000000000222200222
200000000000050222200222
222002222002200222200222
222002222002200222200222
222002222002200222200222
222002222002200222200222
222002222002222220000222
222002222002222220000222
222222200000022222200002
222222200004022222200002
200222200002222000000222
200222200002222000000222
200000000220000002200222
200000000220000082200222
222220000220000222200002
222220000220700222200002
222000000000000220022002
222000600000000220022002
200222222222200220022002
200222222222200220022032
222222222222222222222222
