222222222222222222222222
200000000002222002222002
200000000002222002222002
222002222002222000000222
222002222002222000000222
222002222000022220000222
222002222000722220600222
222002222002222222200222
222002222002222222200222
200002222000000000000222
200002222000000000000222
200220000002222222222002
200220000002222222222002
222222200000000222222002
222222200000000222222402
222002200222200000022002
222002200222200000022002
222000000222222220022002
222000000222222220022002
222002222220000000000002
222002222220800000000002
222002222000022222200002
222002222005022222200032
222222222222222222222222
