222222222222222222222222
200222200000000000000002
200222200000000000000002
200222200222222002222222
200222200222222002222222
200000000222200002200222
200000800222200002200222
222220022222200222222002
222220022222200222222002
222000000002200000022002
222000000002207000022402
222002222002222220000002
222002222002222220000002
222002222000022220022002
222002222005022220022002
222002200222222220022222
222002200222222220022222
222002222002200000000222
222002222062200000000222
200222200222200222200222
200222200222200222200222
200002200000000222200002
200002200000000222200032
222222222222222222222222
