222222222222222222222222
200222222220022000022222
200222222220022000022222
200000000000022222200002
200000000000022222200002
222002222220022002200222
222002222220022002200222
222002222220000000000222
222002222220000000000222
222002200000000222200222
222002200000000222200222
200222222222200222200222
200222222222200222200222
222220022220000002200002
222220022220000072250002
200000000002200222222002
200000800002200222222002
222222222002200220022002
222222222002200220022002
200000000000000000022002
240000000000006000022002
222222222222200002222002
222222222222200002222032
222222222222222222222222
