222222222222222222222222
200000022222222222200002
200500022222222222200002
222002222000000002222002
222002222000000002222002
222002222222222002222002
222002222222222002222002
200000000002222000000002
200000000002222000000002
222220022002222220022002
222220022082222220022002
222000022222200222222002
222000022222200222222002
222000022220000222222002
222000722220000222222002
222220022222200220022002
222224022222200220022002
200220022000000000022002
200220022000600000022002
200000022222200220000002
200000022222200220000002
222220000000000222222002
222220000000000222222032
222222222222222222222222
