222222222222222222222222
200000022000022000000002
200000022000022000000002
200220022222222002222002
200220022222222002222002
222220000000000002222002
222220000000006002222002
222222222220022002222002
222222222220022002222502
200000000000022002222222
200000000000022002222222
222220022222200000000222
222220022222208000000222
222220022220000220022222
222220022220000220022222
200000000222222220000002
200000000222222220000002
200220022002222220022222
200220022002222220022222
222220022220000000022222
222220022220040070022222
222000000222222220000002
222000000222222220000032
222222222222222222222222
