222222222222222222222222
200000022220022222222222
200000022220022222222222
222220022000022000000002
222225022000022000000402
222000022220000002200222
222000822220000002200222
222000022220000222200222
222000022220000222200222
222002200000000222200222
222002200000600222200222
222002222220000222200002
222002222220000222200002
222000000000000220022002
222000000000000220022002
222002222002200222222222
222002222002200222222222
222002222002200000000222
222002222002200000000222
222000022222200220000002
222000722222200220000002
222000022002200222222002
222000022002200222222032
222222222222222222222222
