222222222222222222222222
200222200002222002222222
200222200002222002222222
200000000222222002200002
200000000222222002200002
222222200220000000000002
222222200220000000000072
222222200222222002222222
222222200222222002222222
200002200000000000000222
200002200000000000008222
222000000222222222200222
222000000222222222200222
222002200002200222200002
222002206002200222200002
200002222002222002222222
200002222002222002222222
222002222000000000022002
222002222000000000022002
222000022002200002222222
222000022002240002222222
200222222002222000000002
200222222502222000000032
222222222222222222222222
