222222222222222222222222
200222222000022002222222
200222222000022002222222
200000000222222000000002
200000000222222000000002
200222200220022002222002
200222200220022002222002
222222200000022002222002
222222200000022002222002
222000000222222002200002
222000800222222002200002
200002200222222002222002
200502200222222002222002
222222200000000002222002
222222200000000002222002
222222222220022222200002
222222222220022222200002
200000000000022222222002
200000007000022222222002
222220000222222000000002
222220000222222400600002
200220000000022222222002
200220000000022222222032
222222222222222222222222
