222222222222222222222222
200222200002222002222222
200222200002222502222222
200002222002200002200002
200002222002200002200002
222002222002200222200002
222002222002200222200402
222000022000000222200222
222000022000000222206222
222002222002222222200222
222002222002222222200222
200000000000000000000222
200000000000000000000222
222220022222222220000002
222220022222222220000002
222220022222222222222002
222220022222222222222002
200000000000000000000222
200000000000800000000222
222222200222222222200222
222222207222222222200222
200220000000022220000002
200220000000022220000032
222222222222222222222222
