222222222222222222222222
200222200002222220000002
200222200002222220000002
200000022220000000022002
200000022220000000022402
200222222002222002222002
200222222002222002222002
200222222002222002200222
200222222502222002200222
200000000000000002222222
200000600070000002222222
222220022222200000000002
222220022222200000000002
222000000220000220022222
222000000220000220022222
222002222220022220000222
222002222220022220000222
222002222222200222200222
222002222222200222200222
222000000000022000000222
222000000000022000800222
222002222220022222200002
222002222220022222200032
222222222222222222222222
