222222222222222222222222
200002222222222002200222
200002222222222002200222
222000000000000222200222
222000000000000222200222
222220022222222002200222
222220022222222002200222
200000022222222222200222
200000022222222222200222
222220022000000000000002
222220022000000000050002
222220000002222222222222
222220000002222222222222
200000000222222222200222
200000000222222222200222
222002200220000002200002
222002200220600002240002
222002222002200002222002
222002222002200002222002
222002200002200000000002
222002200002208000007002
222000000000000222222002
222000000000000222222032
222222222222222222222222
