222222222222222222222222
200000000002222000000222
200000000002222000000222
222002222002222000022222
222002222002222000022222
222002222002222000000002
222002222402222000000002
222002222002222000022222
222002222002222000022222
222002222222222000000222
222002222222222000600222
222000000000000000000002
222000000000000000000002
200000000002222002222222
200000000002222002222222
222222222222222000000002
222222222222222000850072
222222222220000002200222
222222222220000002200222
200000000000000222200222
200000000000000222200222
222222222222200222200002
222222222222200222200032
222222222222222222222222
