222222222222222222222222
200000022220022002222002
200000022220022002222002
200000022220022002222002
200000022220022002222002
222220022220000002200002
222220022220700002200002
200220022220022220000222
200220622220022220000222
200220022220022220000222
200220022220022224008222
200220000220022222200222
200220000220022222200222
200220022220022000000222
200220022220022000000222
222000000000000222200222
222000000000000222200222
222002200222200222200222
222002200222200222200222
200002200222200000000002
200002200222200000000002
222222200220022222222002
222222250220022222222032
222222222222222222222222
