222222222222222222222222
200222222222200002222222
200222222222200002222222
200000000002200222200002
200000000002200222240002
222000022000000222200222
222000022000000222200222
222002222000000000000222
222002222000000000000222
222000000002222002222222
222000000002222002222222
222002200002222002200002
222002200002222002200002
222002222002200002200222
222002222082200002200222
222002222002222000000222
222002222002222000000222
222002200002222002200222
222002206002222072200222
200002200220022002200222
200002250220022002200222
222222200220022002200002
222222200220022002200032
222222222222222222222222
