222222222222222222222222
200000000000000222222002
200000000000000222222002
222002222002222220000002
222002222002222220000002
222002222002222000000222
222002222502222080000222
222002222222222002200222
222002222222222002200222
200000000000022222200222
200000000000022222200222
200222222220022220000222
200222222220022220000222
200002200220022220022222
200002200220022220022222
200002222220000000000002
200002222220000000000002
200002200000022222222222
200002200000722222222222
200222200220000002222222
200222200220000062222222
200222200222222000000002
200222200222222000040032
222222222222222222222222
