222222222222222222222222
200002222222222222200002
200002222222222222200002
222000000000000000022222
222000000000040070022222
222002222002222222222002
222002222002222222222002
222002222000000000022002
222002222000000000022002
222000022222222220000002
222000022222222220006002
222220022220000220022222
222220822220000220022222
200000022220000000000222
200000022220000000000222
222002200220022002222222
222002200220022002222222
222002200220022002222002
222002200220022002222002
222000000220022000022002
222000000220022500022002
222000022220022220000002
222000022220022220000032
222222222222222222222222
