222222222222222222222222
200222200220000000000222
200222200220000000000222
200000022222200222200222
200000022222200222200222
222220022000000222200222
222220022000000222200222
222000000002200222222222
222000000002200222222222
222002200002222220000002
222502207002222220000002
222222200000022220022002
222222200000022220022402
200220000220022220022002
200220000220822220022002
200000022220022220022222
200000022220022220022222
222222200220022000000222
222222200220022000000222
200220000000000002200222
200220000060000002200222
200002222222222222200002
200002222222222222200032
222222222222222222222222
