222222222222222222222222
200002222000000222200222
200002222005000222200222
222000000002222220000222
222000000002222220000222
222002222222222220000222
222002222222222220000222
222002200220000220000222
222002200220000220007222
222000022220000000022222
222000822220000000022222
222000022220000222222002
222000022220000222222002
200220000220000222222002
200220000220000222222002
222222200000000000000002
222222200000000000000002
200002200222222222222002
200002206222222222222002
200000000000000222222002
200000000000000222222402
222222222222222220000002
222222222222222220000032
222222222222222222222222
