222222222222222222222222
200222222222222220000002
200222222222222220000002
200000000000000220022222
200000000000000220022222
200222200222200000000002
200222200222200000000002
200222222222200002222002
250222222222200062222002
200000022000000002222002
200000022080000002222002
222222222220022002222002
222222222220022002222402
222220000000022002222002
222220000000022002222002
200000022222222000022222
200000022222222000022222
222000022002222220022222
222000022072222220022222
222002222220000000000002
222002222220000000000002
200222200000022222222002
200222200000022222222032
222222222222222222222222
