222222222222222222222222
200222222000022222200222
200222222000022222200222
200000000222200002200222
200000000222200002200222
200002200222200222200222
200002200222200222200222
200222200220000222200222
200222200220000222240222
222222200220022222200222
222222200220022222200222
222000000000000000000222
222000000000000000000222
222000022002222220000222
222500022002222220600222
222220022000022220000222
222220022000022220000222
200000022222222000000222
200080022222222000000222
222222222002200002200222
222222222002200002200222
200000022000000222200002
200070022000000222200032
222222222222222222222222
