222222222222222222222222
200000000220000220022222
200000000220000220022222
200222222222222220000002
200222222222222220000402
200000000000000222222002
200000000000000222222002
222222200222200220022002
222222206222200220022002
222222200222200222222002
222222200222200222222002
200000000002200220000002
200000000002200220000002
222000000002200000000222
222000700002200000000222
222002222002200002200222
222002222002200002200222
222002222002222222200222
222002222002222222208222
222002222002222222200222
222002222002222222200222
222002222000000002200002
222002222000000502200032
222222222222222222222222
