222222222222222222222222
200222200000000222222002
200222200000000222222002
200002200222200000000222
200002240222200000000222
222002222222200222200222
222002222222200222200222
222000000000000220000222
222000000000000220000222
222002200222222222200222
222002200222222222208222
200002222222200000000222
250002222222200000000222
222222200000000222200002
222222200070000222200002
222222222002222220022002
222222222002222220622002
200000000000000002222222
200000000000000002222222
222002200002200222200222
222002200002200222200222
222002222222200000000002
222002222222200000000032
222222222222222222222222
