222222222222222222222222
200002222220022222200002
200002222220022222200002
222000000220022000000222
222000000220022004000222
222002200000022222200222
222002200000022222200222
222002222220000222200222
222002222220000222200222
200002222220022220000222
200002222220822220000222
200222200222200222200002
200222200222200222200502
200222200222200000000222
200222207222200000000222
200000000000000222200222
200000000000006222200222
222222222220000222222222
222222222220000222222222
222222222220000000022002
222222222220000000022002
200000000000022220000002
200000000000022220000032
222222222222222222222222
