222222222222222222222222
200000000002222000000222
200000000002222004000222
200222222222222222200222
200222222222222222200222
200220000000000222200222
200220000060000222200222
200000022222222222200002
200000022222222222200002
200220022222222002222002
200220022222222002222002
200220000000000000000002
200220000000000000007002
222220022220022220022002
222220022220022220022002
222000022220022220022222
222000022220022220022222
200000022220022222200222
250000022220022222200222
200220022000000000000222
200220022000000000800222
222220022222222220000002
222220022222222220000032
222222222222222222222222
