222222222222222222222222
200000022220000000022222
200000022220000000022222
222220000220022220000002
222220040220022220000002
222000022220022222222222
222000022220022222222222
222002222220000000022002
222002222220000000022002
200000000000022220022002
200000000000022220022002
200222222000022220022222
200222222070022220822222
200222222002222000000002
200222222002222000000002
222220000000022002222002
222220000000022002222002
222000022002222002222002
222000022002222002222002
222002222002222220022002
222002222502222220622002
222002222000000002222002
222002222000000002222032
222222222222222222222222
