222222222222222222222222
200000022000022002200222
200000022000022002200222
222220022002222222200222
222220022002222222250222
222000022000000002200222
222000022000000002207222
222000000002200002200222
222000000002200002200222
222220022222200000000222
222220022222200000000222
200000000222200222200222
200000000222200222200222
222222200220022222200222
222222200220022222200222
222000000220022000000222
222000000220022000008222
222002200222200002200222
222002200222200002200222
200002222220000222200222
200062222220040222200222
222220000002222220000002
222220000002222220000032
222222222222222222222222
