222222222222222222222222
200000000222222000000002
200000000222222000000002
222222200220022002222222
222222200224022002222222
200220000000000002200222
200220800000000002200222
222220022220022220000222
222220022220022220000222
200000022220000000022222
200000022220000060022222
222220022222222220000002
222220022222222220000002
222000000000022222222002
222000000000022222222002
222002222220000000022222
222002222220000000022222
222002200222222000000222
222002200222222000000222
222000000000000222200222
222000000000007222200222
200222222222222220000002
200222222222222225000032
222222222222222222222222
