222222222222222222222222
200000022220000000000002
200000022220000004000002
200222222000022222222222
200222222000022222222222
200222222220022222222222
200222222220022222222222
200000000000000000000002
200000000000000000000002
222222222002222222222222
222222222082222222222222
200222200000022222200222
200222200000722222200222
222002200000000000000222
222002200000000000000222
222000000220000222222002
222500000220000222222002
222220022220000002222222
222220022220000002222222
200000022000022000000002
200000022000022000006002
222222222000022222222002
222222222000022222222032
222222222222222222222222
