222222222222222222222222
200002222000022220000002
200002222000022220050002
222002222002222220022222
222002222002222220022222
222002222000000220000222
222002222000000220000222
222000000002200222200222
222000000002200222200222
222002222222200002200222
222002222222200002200222
222000000222222000000222
222000008222222000000222
222002200000022220022222
222002200000022220022222
200002200220022220000002
200002200220022220000002
200222222222222220000222
200222222222222220007222
200000000002200000000222
200000000002200000600222
222222200002222220000002
222222240002222220000032
222222222222222222222222
