222222222222222222222222
200002200222222002222222
200002200222222002222222
222002222000022002200002
222002222000022002200402
222002222000000002200222
222002222000600002200222
222000000002222222200222
222000000082222222200222
222002222002222222200222
222002222002222222200222
222002222000000000000222
222002222000000000000222
222002200220000220000222
222002207220000220000222
200000022222200220000222
200000022222200220000222
200222222002200002200222
200222222002200002200222
200222200002222002200222
200222200502222002200222
200002222000000002200002
200002222000000002200032
222222222222222222222222
