222222222222222222222222
200002200002222222200222
200002200002222222240222
222002200220000000000222
222002200220000000000222
222002222222222222200222
222002222222222222207222
222002200002222222200002
222002200002222222200002
222002200000000000000002
222002250000000000000002
222002222222200000022222
222002222222200000022222
222000000222222002222222
222000000222222002222222
222002222220022000000002
222002222220022000000002
222000000000000000022222
222000000000000000022222
222000022222200222222222
222000022222208222222222
222000022220000000000002
222000622220000000000032
222222222222222222222222
