222222222222222222222222
200002222222222220000222
200002222222222220000222
200222200000000000000222
200222200000000000050222
200000000222222222200002
200000000222222222200002
222222200002222222222222
222222200002222222222222
222222200222200000000222
222222200222200000800222
200000000002200222222002
200000000002200222222002
222222200000000222222002
222222200000000222222002
200000000002200000000222
200000000002206000700222
200222222222222222200222
200222222222222222200222
200220022220000000000222
200224022220000000000222
200000022220022222200002
200000022220022222200032
222222222222222222222222
