222222222222222222222222
200000000222222220000002
200000000222222220000002
222000022220000000022222
222000022220000000022222
222000022222200222222222
222000022222200222222222
222000000000000000000002
222000000000000080000002
222002222002200222222222
222002222072200222222222
222002222002200222200222
222002222002200222200222
200002222222200222200222
200002222222200222200222
200222200222200002200222
200222200222200062200222
200222200220000002200222
200222200220000002200222
200220000000000000000002
200220000000000000040002
200222222002222222222002
250222222002222222222032
222222222222222222222222
