222222222222222222222222
200000000000022220000222
200000000000022220000222
222220022220022222200222
222220022220022222200222
222002222000000002200222
222002222000000502200222
222002222002222002200002
222002222082222002200002
222002200000022222200222
222002200000022222200222
222000000222222222200222
222000000222222222206222
222002200222200000000002
222002200222200000000002
200002200000000220000002
200002200000000220000002
200222200220022220022222
200222200220022220022222
200002222220022220022222
200402222220022220022222
222222200000022220000002
222222200070022220000032
222222222222222222222222
