222222222222222222222222
200222200222222222200002
200222200222222222200002
200222200000000000022002
200222200080000000722002
200222200222222002222222
200222200222222002222222
200000000002222000000002
200000000002222000000002
200222200000000222200222
200222200400000222200222
222220000220022222200222
222225000220022222200222
200222222222222002200222
200222222222222002200222
222000000002222002200222
222000000002222002200222
222000022000000000000002
222000022000000000006002
222002222222222002222002
222002222222222002222002
222000000220022002222002
222000000220022002222032
222222222222222222222222
