222222222222222222222222
200000000002222002222002
200000000502222002222002
200222222220022000000222
200222222220022000000222
200000000222200002222222
200000700222200002222222
222222200222200222200002
222222206222200222200402
200220000222200222200222
200220000222200222200222
200220022220000222200222
200220022220000222200222
222000022220000000000222
222000022220000000800222
222220022220022222200222
222220022220022222200222
200000000000000222200222
200000000000000222200222
200222222002200002222222
200222222002200002222222
200002222002222000000002
200002222002222000000032
222222222222222222222222
