222222222222222222222222
200220022000022220000002
200220022000022220000002
200222222000022000022002
200222222000022000022002
200000000000000002222002
200000000000000002222002
200222222220000002222002
200222222220000002222002
222222222222222002200002
222222222222222002207002
222000000002200002200222
222000000002200002200222
222002200000000222200222
222002200000000222200222
222002222222200222200222
222002222222208222200222
222002222222222002200222
222002222222222002200222
222000000000022220000002
222060000500022220000402
200222222222200002222002
200222222222200002222032
222222222222222222222222
