222222222222222222222222
200002200222200220000002
200002200222200220000002
222002222000022220022222
222002222000022220022222
222002222220022220022002
222002222220022224022002
222000000000000000022222
222000000000000000022222
222002222222222000000002
222002222222222000000002
200000022222222002222222
200000022222222002222222
200000000000022220022222
200000000000022220022222
200222222220022222200002
200222222220022222208002
200002222220022002200222
200502222220022072200222
222222200220000000000222
222222206220000000000222
200220000000022222200002
200220000000022222200032
222222222222222222222222
