222222222222222222222222
200222222222222220000222
200222222222222220000222
200000000000000000022222
200000000000000000022222
222002222222222222222002
222002222222222222222002
222000022002200222222002
222000022002240222222002
222000000222200000000002
222000000222200000800002
222000022002222222222002
222000022002222222222502
222000022220000002222002
222000022220000002222002
222002222000000222222002
222002222000000222222002
222002222002200000000002
222002222002200000600002
222000000002200002222222
222000700002200002222222
222002222222200000000002
222002222222200000000032
222222222222222222222222
