222222222222222222222222
200000022220022222200222
200000022220022222200222
222220022220000000000222
222220022220000000000222
222000000000022222200222
222000000000022222208222
222002222220022220000002
222502222220022220000002
222000022220022220022222
222000022220722220022222
222000022220022220000222
222000022220022220000222
222222222000022220000222
222222222000022220000222
200220022000022000022002
200220022000622000022402
200222222220022222222002
200222222220022222222002
200220000000000002222002
200220000000000002222002
200000000222222000000002
200000000222222000000032
222222222222222222222222
