222222222222222222222222
200002222222222000000222
200002222222222000000222
222000000000000002200222
222080000000007002200222
222002222000022222200222
222002222000022222200222
222002222000000222200222
222002222000600222200222
200000022222222222200222
200000022222222222200222
200220022222222000000002
200220022222222000000002
200220000000022222222002
200220000000022222222002
200002222220022222222002
200002222220022222222002
200002222000000000022002
200002222000000000022002
222220000000000222222002
222225000000000222222402
200220022222200002222002
200220022222200002222032
222222222222222222222222
