222222222222222222222222
200220022002222000022222
200220022002222000022222
200222222000022220000002
200222222000022220000002
200000022002222002222002
200000022002222002222002
222220000000000002222002
222220000000000402222002
222222222000000002222002
222222222000008002222002
200000000002222000000002
200000000002222000000002
222002200220022002200002
222002207220022062200002
222002200222222002222222
222002200222222002222222
222002222220022002222222
222002222220022002222222
222002222220000000000002
222002222220000005000002
222000000222222222222002
222000000222222222222032
222222222222222222222222
