222222222222222222222222
200222222220022220000002
200222222220022220000002
200000000220000000022002
200000600220000000022002
200222200220022222222222
200222200220022222222222
222220000000022222200222
222220000000022222200222
222222222002222002200002
222222222002222002200002
200002222002222002200002
200002222002222002200002
200222222000000000000222
200222222000000000700222
200000022222222002222222
200000022222222002222222
222220022220000002222002
222220022220000002222502
200000000000022002222002
200000000000022082222002
200222222222222000000002
200222222222222400000032
222222222222222222222222
