222222222222222222222222
200002222000000000022222
200002222004000000022222
222002200222222220000002
222002200222222220000002
222002222002200000022222
222002222062200000022222
222002222000000222200222
222002222000000222200222
222002222002222222200222
222002222002222222200222
222002200002222002200222
222002200002222002200222
200000000222222000000002
250000000222222000700002
200222200000022002222002
200222200000022002222002
200222200220000002200002
200222200220000002208002
222222200222222002200002
222222200222222002200002
222000000002222002222002
222000000002222002222032
222222222222222222222222
