222222222222222222222222
200222200000000222222222
200222200000000222222222
200222200002200220000002
200222200002200220000002
200000000222200000022222
200000000222200000022222
222220022222222222200222
222220022222222222200222
222000000000000002200222
222000000000000002200222
222002200222222222200222
222002208222222222206222
222002200220000222200222
222002200220000222200222
222220000000000222200222
222220700000050222200222
200000022220000222200222
200000022220000222200222
200222222222200000000002
200222222222200000000002
222220000000000222222002
222220040000000222222032
222222222222222222222222
