222222222222222222222222
200002222222222002222222
200002222222222002222222
222002200000000220000002
222002200000000220000002
222000000002222222222002
222000000002222222222002
200002222002222002222002
250002222002222062222002
222000022000000000000002
222000022000000000000002
222222222002222220022222
222222222002222220022222
200222222222222220000222
200222222222222220000222
200000000000000000000222
200000008000000000000222
200222222002200002222002
200222222002207002222002
200222200002200222222222
200222200402200222222222
200002222222200000000002
200002222222200000000032
222222222222222222222222
