222222222222222222222222
200000000000000002200222
200000000000000002240222
200222222222222222200222
200222222222222222200222
200222222222222220000002
200222222222222220000002
200000000000000222222002
250000000000000222222002
222002222222200000000002
222002222222200000000062
222002222002222002222222
222002222002222002222222
222002222002200002222222
222002222082200002222222
200000022002200000000002
200000022002200070000002
200220022002200222200222
200220022002200222200222
200220000002200222222222
200220000002200222222222
200222222222200000000002
200222222222200000000032
222222222222222222222222
