222222222222222222222222
200002222220000222200222
200002222220000222200222
222000000000022222200222
222000000000022222200222
222002222220000000000222
222002222220000000000222
222000000220022002222222
222000000220022002222222
222220022220022002222002
222220022220022002222002
200220022220022000000002
200220022220022000000002
200220000220022002222222
200220000220022062222222
200222200220022000000222
200222200220022000000222
200222200220022222200222
200222200220022222200222
200000000002222000000002
250000800002222070000402
222222222222200002222002
222222222222200002222032
222222222222222222222222
