222222222222222222222222
200000022222200222222002
200000022222200222222002
200220000000000220000222
200220000000000220000222
200222222220022220022222
200222222220022220022222
200002222220022220022002
200002222220022220022002
200222200000022220000002
200222200000022220050082
222220022220000000022222
222220022220000000022222
222000000220022000000222
222000000220622000000222
222220022220022222200222
222220022220022222200222
200000022220022222200222
200400022220022222200222
200000000220022000000222
200000000220022000000222
222222200000022222200002
222222200070022222200032
222222222222222222222222
