222222222222222222222222
200002200222222222200222
200002200222222222200222
222002222000000000000222
222002222000000000000222
222002222220000002200002
222002222220000002200002
222002200222200002200002
222002200222207002200002
200000000002222222200222
200000000002222222200222
200220000222200220000222
200220000222200220600222
222222200000022220022222
222222200000022224022222
222000000222222220022002
222000000222222220022002
222002222222200220000002
222002222222200220000502
222000000000000000022002
222000000000000080022002
200222222222222002222002
200222222222222002222032
222222222222222222222222
