222222222222222222222222
200002222220022222200002
200002222220022222200002
222000000000022002222002
222000000000022002222002
222002222222222000022002
222002222222222000022002
222002222002222000000002
222002222002222000600002
222002222000022220022002
222002222000022220022002
222000000000022220022222
222000000000722220022222
222002200220000000000222
222002200220000000000222
200002222222222222200222
200002222222222222200222
200222222000000222200002
200222222000000222200002
200000000222200000000002
200005008222200000000002
222222200002222222222002
222222200402222222222032
222222222222222222222222
