222222222222222222222222
200002222002200002222222
200002222002200002222222
222000000002200222200002
222000000002200222200402
222000000222200222200222
222000000222200222200222
200002200002200000000222
200502200002200000000222
222222200000000222200222
222222208000000222200222
222222200222200222200222
222222200222200222207222
200000000222200222222002
200000000222206222222002
222222200222200000000222
222222200222200000000222
222000000222200222200222
222000000222200222200222
200002200002222002200222
200002200002222002200222
222222200000022220000002
222222200000022220000032
222222222222222222222222
