222222222222222222222222
200000000002222222222222
200000000002222222222222
222222200222200000000002
222222200222200000000002
200222200222222220022222
200222208222222220022222
222002200000022220022222
222002200000722220022222
222000000220000220000002
222000000220000220000502
222220000222200220022222
222220000222200220022222
200000022222200000000002
200000022222200060000002
200220000002200222222222
200220000002200222222222
200222200222200000022222
200222200222200000022222
200222200002222002222002
240222200002222002222002
200222200222200000000002
200222200222200000000032
222222222222222222222222
