222222222222222222222222
200000000000022222222222
200000000000022222222222
200222222220022000000002
200222222220022000000002
200000022220022002200222
200000722220022002200222
200222222000000002200222
200222222000000002200222
200222222220022222222222
200222222220022222222222
200220000002200220022002
200220000002200220022002
200222222002222000000002
200222222082222000000002
200000000000000002200222
200000006000000002200222
222002222222222222200222
222002222222222222250222
222002222222222222200222
222002222222222222200222
200222200000000000000002
200222200004000000000032
222222222222222222222222
