222222222222222222222222
200002222222222220000222
200502222222222220000222
222000000000000222200222
222000000000000222200222
222002200002222222200222
222002200062222222200222
222002222222200000000222
222002222222200000000222
222002222222222000000002
222002222222222000000002
222000000000022002222002
222000000000022002222002
222002222000022002222222
222002222080022002222222
200002222220000000000222
200002222220000000000222
222222200000000222200002
222222200000000222200002
222002200222200222200002
222002200222240222207002
222000000002222002200002
222000000002222002200032
222222222222222222222222
