222222222222222222222222
200000000222222222222222
200000000222222222222222
200222200220000000000002
200222200220050000000002
200002222002222220022222
200002222002222220022222
222002222222200220022002
222002222222200220022002
222000000000022220022002
222000000000822220022002
222002222002200220022222
222002222072200220022222
222002222002222000000002
222002222002222000000402
222222222000022222222002
222222222000022222222002
200220022220022220000002
200220022220022220000002
200000000220000220022222
200000006220000220022222
222222200000000000000002
222222200000000000000032
222222222222222222222222
