222222222222222222222222
200000000000022220022002
200000000000022220022002
222002222220022220022002
222002222220022220022002
222002222220022220000222
222002222220022220000222
200222200000000222200222
200222200060000222200222
200222200222200000000002
200222208222200000000002
222000000222200222222222
222000000222200222222222
222002222222222002200002
222002222222222002200002
222002222000000000022222
222002222000000000022222
200002222002222002222002
200002222002222002222002
200000022002222000000002
200000022072222000050002
222220000000022222222002
222220000004022222222032
222222222222222222222222
