222222222222222222222222
200220022220000222222002
200220022220000222222002
200220022220022220000222
200220022220022220000222
200000000000022222200222
200000000000022222240222
200002222002222002200002
200002222072222002200002
222220022002222002222002
222220022002222002222002
222222222000000002200002
222222222000006002200002
200000000000022000000222
250000000000022000000222
222220022220022222200222
222220022220022222200222
222000022220022222200222
222000022220022222200222
200222200000000002200222
200222200000000002200222
200220000222222222200002
200220008222222222200032
222222222222222222222222
