222222222222222222222222
200000000222222222200002
200000000222222222200002
200000000000000000022222
250000000000000000022222
200222222000022222222002
200222222000022222222002
222222200002222222222002
222222208002222222222002
222002222000000000022002
222002222000000000022002
222000000002222220022002
222000000002222220022002
222002200000022220022002
222002206000022220022002
222002222220022000000002
222002222220022000000002
222002222222222002222222
222002222222222002222222
222000000002222000000222
222000007002222000000222
222002222000022222200002
222002222400022222200032
222222222222222222222222
