222222222222222222222222
200222222222222002222222
200222222222222002222222
200000000000000000000002
200000000000000000000002
200002222222222222222002
200002222222222222222002
222002222222200220022002
222002222222250220022002
222002200000000222200002
222002206000000222207002
222002200222222002200222
222002200222222002200222
222002200222222222200222
222002200222222222200222
200000000000000002200002
200000000000000002208002
200222200220000222200002
200222200220000222200002
200002222222222222222002
200002222222222222222002
222222200000000000000002
222222240000000000000032
222222222222222222222222
