222222222222222222222222
200222222222222002222002
200222222222222002222002
200000000000022000000222
200000000000022000000222
222220022000000222200222
222220022000000222208222
222000022002222220000222
222000022002222220000222
222002222000000220022222
222002222000000220622222
200002222220022220000002
200002222220022220000002
222000000220022000022222
222000007220022000022222
222002222220000000000222
222002222220000000000222
222000022222200222222222
222500022222200222222222
222002222000000000022002
222002222004000000022002
200002222002222220000002
200002222002222220000032
222222222222222222222222
