222222222222222222222222
200222222222222222222002
200222222222222222222002
200000000000000000000222
200000000000000000040222
200222222222222222200222
200222222222222222200222
200002200222200222200222
200002206222200222200222
200222222000000222200222
200222222000000222200222
200000000000022222200222
200000007000022222200222
222220022220022002222002
222220022220022002222002
200000022220000002222002
200000022220800002222002
200220022222200000000222
200220022222200000000222
200222222002222002222222
250222222002222002222222
222220000000000000000002
222220000000000000000032
222222222222222222222222
