222222222222222222222222
200222200000000000022222
200222200000000000022222
200222200222222220022002
200222200222222220022002
200222200222222000022002
200222200222222400022002
200000000000022222200002
200000008000022222200002
222220022222222222200222
222220022222222222200222
222000022222200002200222
222000022222200002200222
222002222000000222200222
222002222000000222200222
222002222220000000000222
222002222220700000000222
222000000000000002200002
222000000000006002200002
222002222000022222222002
222002222000022222222002
222002222002222000000002
222002222002222005000032
222222222222222222222222
