222222222222222222222222
200222222220000002222002
200222222225000002222002
200000000002222000000222
200000000002222000000222
222220022000022222200222
222220022000022222200222
222000022002222222200222
222000022002222222200222
222002222000000000000222
222002222000800000000222
222002222220022220022002
222002222220022220022002
222000000220000000022002
222000000220000000022002
200002222220000222222002
200002222220007222222002
200222222222200222200222
200222222222200222200222
222220000000000222200222
222224000000600222200222
200002222222200000000002
200002222222200000000032
222222222222222222222222
