222222222222222222222222
200002222002200222222002
200002222002200222222002
222002222002222000000222
222002222002222000000222
222002222000000002222222
222002222000000002222222
222002222000022222200002
222002222000022222206402
222000022220022002200222
222000022220022002200222
222220000220022222200222
222220000220822222200222
200222200000000000000002
250222200000000000000002
200222222000022002222222
200222222000022002222222
200000000002222002200222
200000000002222002200222
200000022222200000000002
200000022222200000700002
222220000222200222222002
222220000222200222222032
222222222222222222222222
