222222222222222222222222
200220022222222222222222
200220022222222222222222
200222200000000000000002
200222200000000000000402
200002222222200222222222
200002222222200222222222
222002222220000000000002
222082222220000000000002
222000000002200220022222
222000000062200220022222
222220022222200222222222
222220022222200222222222
200220000222200000000002
200220000222200070000002
200000000220000220022222
200000000220000220022222
200222200000022220000222
200222200500022220000222
200002200220022222200002
200002200220022222200002
222222200220000002222002
222222200220000002222032
222222222222222222222222
