222222222222222222222222
200222222220000000022002
200222222220000000022002
200000000000022222222222
200000000000022222222222
200220022220000222200002
200220022220000222200002
222222222002200222200222
222222222002250222200222
222002200002200222200222
222002208002200222200222
222002222000000222200222
222402222000000222200222
222000000002200000000222
222000000002206000000222
200222200002222222200222
200222200002222222200222
222002222002200222200222
222002222002200222200222
222002200000000220000222
222002200000000220700222
222000000222222220000002
222000000222222220000032
222222222222222222222222
