222222222222222222222222
200222222222222220000002
200222222222222220000002
200000000000000000022222
200000000000000000022222
222222222220000002222222
222222222220000002222222
222002222000022000000002
222002222000822070000002
222002222220022000000002
222002222220022000000002
222002200000022000022002
222002200000622000022402
222002200220000222222222
222002200220000222222222
222002200222200002200222
222002200222200002250222
222000000222222222200222
222000000222222222200222
222000000000000000000222
222000000000000000000222
200222222222222222200002
200222222222222222200032
222222222222222222222222
