222222222222222222222222
200222222222222222222002
200222222222222222222002
200000000000000000000222
200000000000000000000222
222222222002222002200222
222222222002222002200222
222222200002222002222002
222222200072222082222002
200002200002222000022002
200002200502222000022002
200000000000022220022222
200000000000022220022222
200222200002222000000002
200222200002222000000002
200002200222222222200222
200002200222222222200222
200222222220000000000222
200222222220000000000222
222220000000022220022222
222224000060022220022222
222000022222200220000002
222000022222200220000032
222222222222222222222222
