222222222222222222222222
200222200220022002222002
200222200220022502222002
200000000220022000000222
200000000220022000000222
222222200002200222200222
222222200002200222200222
222222200002222000000222
222222200002222000600222
200002222002200222200222
200002222002200222200222
222000000002222000000222
222000000002222000000222
222002222000022002200002
222002222080022002200002
222002200000000002200222
222002200000000002200222
222002222220022222200222
222002222220722222200222
222000000222222222200222
222000000222222222200222
222002222002200000000002
222002222002200400000032
222222222222222222222222
