222222222222222222222222
200222222000022222222002
200222222000022222222402
200000022002222000022002
200000022502222000022002
200222200002222002222002
200222200002222002222002
200000000222200000000002
200000006222200000800002
200222200222200220022222
200222200222200220022222
222222200222222220022222
222222200222222220022222
222000000220022220000002
222000000220022220000002
222002222220000000022002
222002222220000000022002
222000000220022220022222
222000007220022220022222
200000000000000002222222
200000000000000002222222
222222222222222000000002
222222222222222000000032
222222222222222222222222
