222222222222222222222222
200000000222222222200222
200000000222222222200222
200222222220000000000222
200222222220000004000222
200000022222200222222002
200000022222200222222002
222220000000000222222002
222220000000000222222002
222222200222200000000222
222222206222200000000222
200000000222222002200222
200000000222222002200222
222220022220000002222222
222220022220700002222222
222000022002222000022002
222000022002222000022502
222002200000000002222002
222002200080000002222002
222002222222200222222002
222002222222200222222002
222000022002200000000002
222000022002200000000032
222222222222222222222222
