222222222222222222222222
200000000220022222222222
200000000220022222222222
222002222222200000000002
222002222222200000000002
222002222000000220022222
222002222000000220022222
222002222002222220022002
222002222002222220022402
222002222220000000022002
222002222220000070022002
200000000000022220022002
200000800000022220022002
200222222222222220022002
200222222222222220022002
200000022222200222222002
200000022222200222222002
222220022000000220000002
222220022000000220000502
200220000000000000022002
200220006000000000022002
200002222222222222222002
200002222222222222222032
222222222222222222222222
