222222222222222222222222
200222200222222220022002
200222200222222220022002
200000000000000000022222
200000000000000000022222
200222200222222000000002
200222200222222000000002
222220000002222002222002
222220700002222002222002
222000022002222002222002
222000022502222062222002
222002222000022220022002
222002222000822220022002
200000022220022222200002
200000022220022222200002
222222200220000002200222
222222200220000002200222
222222222220022002200222
222222222220022002240222
200000000000022002200222
200000000000022002200222
222222222220022222200002
222222222220022222200032
222222222222222222222222
