222222222222222222222222
200222222000000220000002
200222222000000220000002
200000000002200220022222
200000000002200220022222
200222222222200000022222
200222222222207000022222
200000022222222220022002
200000022222222220022002
222220000000022220000002
222220000000022220008002
222220022222222220022222
222220022222222220022222
200000022220000000022222
200500022220000000022222
222222222222200220022002
222222222222240220022002
200000000000000220000002
200000000000000220600002
222220022222200222222002
222220022222200222222002
200220022220000222200002
200220022220000222200032
222222222222222222222222
