222222222222222222222222
200222200220000002200222
200222200220000002200222
200000000222222222200222
200005000222222222200222
222002222000000000000002
222002222000000000000002
222002222002222222222002
222082222002222222222002
200000022222200222200002
200000022222200222200002
222220000220000222200222
222220000220000222240222
200222200000000222200222
200222206000000222200222
222000000222200222200222
222000000222200222200222
222002200220000002200222
222002200220000002207222
222002200222222000000002
222002200222222000000002
222002222000000222222002
222002222000000222222032
222222222222222222222222
