222222222222222222222222
200000000000000000022002
200000000000000000022002
200222222002200000022222
200222222002200000022222
200222222002222220000002
200222222002222220000002
222220022002222222222222
222220022002222222222222
200220000000000002222222
200220000000000002222222
222000022002222222200002
222000722002222222250002
222220022000022222200222
222220022000022222208222
200000022220000000000222
200000022220000060000222
200222222222200222222222
240222222222200222222222
222220000000000000000002
222220000000000000000002
200000022222222222222002
200000022222222222222032
222222222222222222222222
