222222222222222222222222
200222222002222000022002
200222222002222000022002
200000000002200000022002
200000000002200000022002
200002222222200220000222
200002222222200224006222
222002222002222222200222
222002222002222222200222
222002222002222002200222
222002222082222002200222
200002222002222000000222
200002222002222000000222
222002200000000000022002
222002200070000000022002
222000000222222002222002
222000000222222002222002
222002200002222002222002
222002200002222002222002
222002222002222222222002
222002222002222222222002
222002222000000000000002
222002222000000500000032
222222222222222222222222
