222222222222222222222222
200222222222200000022222
200222222222200000022222
200000000000000000000002
200000000000000400000002
222002222000000220022222
222002222000000220022222
222000022222200220022222
222000722222200220622222
222220022220000000000002
222220022220000000000002
200000022220022222222002
200500022220022222222002
222222222000022222222002
222222222000022222222002
222000000002222000022222
222000000002222000822222
222002222002222220000222
222002222002222220000222
200002222000000000000002
200002222000000000000002
222220022002222222222002
222220022002222222222032
222222222222222222222222
