2222222222222222222222
2002222002222220000002
2002222502222220000002
2000000000000000022222
2000000000000000022222
2002222222200002222222
2002222222200002222222
2002222222200222200002
2002222222200222200002
2000000002200222200222
2000000002207222200222
2002222222200222200222
2002222222200222206222
2002200002200222200222
2002200002200222200222
2002222222200222200222
2002222222200222208222
2002200002200222200222
2002200002200222200222
2222200000000000000002
2222200400000000000032
2222222222222222222222
