2222222222222222222222
2000000002222000022002
2000000002222000022002
2222222002222002222002
2222222002222002222002
2002222002222000000222
2002222002222004000222
2220000000022220022222
2220000060022220022222
2220000222200220000002
2220000222207220000002
2220022222222220000222
2220022222222220000222
2000000000000222200222
2000000000000222200222
2220022222200222200222
2220022222200222208222
2220000220000000000002
2220000225000000000002
2002222220022222222002
2002222220022222222032
2222222222222222222222
