2222222222222222222222
2002222220022222222002
2002222220022222222002
2000000002200000000222
2000000002200000000222
2220022002200222200222
2220022002200222200222
2220022000000222200002
2220022000600222200002
2000022222200222200222
2500022222207222200222
2222222000000220000222
2222222000000220800222
2222200002200000022222
2222200002240000022222
2002222002222222222002
2002222002222222222002
2000000000000000000002
2000000000000000000002
2222222002222222222002
2222222002222222222032
2222222222222222222222
