2222222222222222222222
2002222222222220000002
2002222222222220000002
2000000000000222222002
2000000000000222222002
2222200222200222222002
2222200222200222222002
2000000222200000000002
2000000222207000000002
2002200222200222222002
2002200222200222222002
2002200222200222222002
2002200222200222222002
2002222220000000022002
2402222220006000022002
2000022222200222222002
2000022222250222222002
2222222000000002222002
2222222000000082222002
2002200002222220022002
2002200002222220022032
2222222222222222222222
