2222222222222222222222
2000000000000220022002
2000000000000220022402
2002222000000220022002
2002222000000220022002
2002222002222222222002
2002222002222222222002
2222222002222000000002
2222222502222000700002
2220000002222222200222
2220008002222222200222
2220022000000222200222
2220022000000222200222
2220022222222000000222
2220022222222000000222
2220022220000002200002
2220022220000002200002
2220000000022002222002
2220006000022002222002
2220022222222002222002
2220022222222002222032
2222222222222222222222
