2222222222222222222222
2002222220000002222222
2002222220000002222222
2000000000022000000002
2000000000022000000502
2002222220022222222222
2002222220022222222222
2000022220000222200002
2000022220000222200002
2220000222200222200222
2220000222200222207222
2222222222200000000222
2222222222200000000222
2000000000000222222222
2000006000008222222222
2002222220022222222002
2002222220022222222002
2000022220000000022002
2004022220000000022002
2222222000022220000002
2222222000022220000032
2222222222222222222222
