2222222222222222222222
2000022000000222200002
2000022000000222200002
2220022002222220022222
2220022002222220022222
2220000000000220022002
2220000000000220022002
2002222222200000000002
2002222222200000700002
2222222222222002222222
2222222222222082222222
2000000000000002222222
2000000000000002222222
2220022222222002200002
2224022222222062250002
2220022220022002200222
2220022220022002200222
2220022220000000000222
2220022220000000000222
2220022220000222200002
2220022220000222200032
2222222222222222222222
