2222222222222222222222
2002222002200222200002
2002222002200222200002
2000022002200222200222
2000022002200222200222
2220000000000222200222
2220006000000222208222
2220022222200000000222
2220022222200000000222
2002222222222000022222
2002222222222000022222
2222200000000000000002
2222200000000000007002
2002222222200222222002
2002222222200222222002
2000022222200222200002
2000022222200222250002
2220000000000002222002
2220040000000002222002
2220022222222002222002
2220022222222002222032
2222222222222222222222
