2222222222222222222222
2002222222222222200222
2002222222222222250222
2000000000000002200222
2000000000000002200222
2000022222222002200002
2000022222222002200002
2220022002222000000002
2220022402222000600002
2220022002222002222222
2220022072222002222222
2220000002200000022222
2220008002200000022222
2220022222200220000002
2220022222200220000002
2220022222200222222002
2220022222200222222002
2000022000000222200002
2000022000000222200002
2000022222222002200002
2000022222222002200032
2222222222222222222222
