2222222222222222222222
2002222222200222200222
2002222222200222200222
2000000000000222200222
2000000000050222200222
2222222002222222200222
2222222002222222200222
2220000002222000000222
2220000062222000000222
2000000002222002222222
2000000002222082222222
2002200002222002222002
2002200002222002222002
2002222002200000022002
2002222002200000022002
2222222002200000000002
2222222002200000007002
2220000000000220022002
2220000000000220022402
2220022222222220022002
2220022222222220022032
2222222222222222222222
