2222222222222222222222
2000000000022222200002
2000000000022222200002
2002222222222000022002
2002222222222000022002
2000000222200002222002
2005000222200062222002
2222200222200222200222
2222200222208222200222
2220000000000002200222
2220000000700002200222
2002222222222000000222
2002222222222000000222
2220022222222002222222
2220022222222002222222
2220000000000002222002
2220000000000002222002
2220022222200222222002
2220022222200222222002
2220000222200000000002
2224000222200000000032
2222222222222222222222
