2222222222222222222222
2000022002222002200002
2000022002222002200002
2220022002222002222222
2220022002222002222222
2220022002222002200002
2220022002222002200502
2220022002222000000002
2220022002222000000002
2220022000022002222222
2220022000022002222222
2220022000000000000222
2220022060000000000222
2220000002200222222222
2220008002200222222222
2220022222200220022002
2220022222200220722002
2220022222200222222002
2220022222200222222002
2002222000000000000002
2002222000000000040032
2222222222222222222222
