2222222222222222222222
2000000222200222200222
2000000222200222200222
2220000222200222200222
2220000222200222200222
2220022222200222200222
2220022222200222200222
2220000000000222200222
2220000000000222200222
2000022222222220000002
2000022222222220000002
2002222002222000022002
2002222502222004022002
2000000000022002222002
2000000000622002222002
2222222220000002222002
2222222220008002222002
2000000000022222200002
2000000070022222200002
2222222220000002222002
2222222220000002222032
2222222222222222222222
