2222222222222222222222
2000000002222222222222
2000000002222222222222
2002222222200000000002
2002222222200000000002
2000000000000222200222
2000000000000222200222
2222222220000222200222
2222222220800222200222
2002200222200222200222
2002200222200222200222
2002200222200222222222
2002200222200222222222
2220000000000220000002
2220000000000220006502
2220022222200000000222
2220022222200000000222
2220022222200002200222
2220022222200072200222
2000000002222222200002
2000040002222222200032
2222222222222222222222
