2222222222222222222222
2000000000000222200222
2000000000000222200222
2222222222200002200222
2222222222200002250222
2002200220000000000222
2002208220000070000222
2220022220022222200222
2220022220022222200222
2220000000000220000002
2220000060000220000002
2220022002222222200222
2220022002222222200222
2220022000022000000222
2220022000022004000222
2220022220022222200002
2220022220022222200002
2220022220022220000002
2220022220022220000002
2220022220022002222002
2220022220022002222032
2222222222222222222222
