2222222222222222222222
2000022220022002200222
2000022220022002200222
2220022220022002200222
2220022220022002200222
2220022220022222200222
2220022220022222200222
2220022220000000000002
2220022220800000006002
2220022222200222222002
2220022222200222222002
2220000000000222200002
2220000000000222200002
2220022220022220000002
2220022220022220000002
2220000220022220022002
2220050220722224022002
2002222220000222222002
2002222220000222222002
2000022000000220022002
2000022000000220022032
2222222222222222222222
