2222222222222222222222
2000000222222222222222
2000000222222222222222
2222200220000000000002
2222200220000000000002
2002200222222222222002
2002200222222222222002
2220000002200222222002
2220000002200222222002
2220022000000000022002
2220022000000000022002
2220022002222000000002
2220022072222000600002
2220022222222220022222
2220022222222220022222
2220022220000000022222
2220022220000500022222
2220000220022000022002
2224000220022080022002
2002222220022000000002
2002222220022000000032
2222222222222222222222
