2222222222222222222222
2000000000000000000002
2000000000000000000502
2222222002222222222002
2222222002222222222002
2222222002222220022002
2222222002222220022002
2000000000000002222222
2000000004000002222222
2002222222200222200222
2002222222200222200222
2000000222200222200222
2000007222200222200222
2222200222222222200222
2222200222222222200222
2000000220000000000222
2000008220000060000222
2220022220022222200222
2220022220022222200222
2220000000022002200002
2220000000022002200032
2222222222222222222222
