2222222222222222222222
2000000000000000022002
2000000000000000022002
2002200222222220022002
2002200222222220022002
2222200222222222222002
2222200222222222222002
2220000000000000000222
2220007000000005000222
2220000220022222222222
2220000220022222222222
2220022220022220022002
2220022220822220022002
2220000220022220022002
2220000220022220622002
2220022220000220000002
2220022220000220000002
2220022220000000022002
2220022224000000022002
2220022002222222222002
2220022002222222222032
2222222222222222222222
