2222222222222222222222
2000000000000002222222
2000000000040002222222
2000000222222222200002
2005000222222222200002
2002200000000000000222
2002200070000000000222
2002222222200222200222
2002222222200222200222
2222222220000220000002
2222222220000220000002
2220000000000222222222
2220000000000222222222
2220022222222222200222
2220022222222222200222
2220022002222002200222
2220022062222082200222
2220000000000000000002
2220000000000000000002
2002222222222222222002
2002222222222222222032
2222222222222222222222
