2222222222222222222222
2000022222222222200222
2000022222222222200222
2002222000000002200222
2002222000000002200222
2002222002222000000222
2002222002222000800222
2002222222200002222222
2002222222200002222222
2000000222222000000002
2000000222222000000402
2222200220000000022222
2222200220700000022222
2220000220022220000002
2220000220022220000002
2220000000022222222222
2220000000022222222222
2000000220000000000222
2000000220000060050222
2222200222222222200002
2222200222222222200032
2222222222222222222222
