2222222222222222222222
2000000002222222200002
2000000002222222200002
2220022000000000022222
2220022000000000022222
2220022002222222222002
2220022002222222222002
2000022000000222200002
2000022000000222200002
2222222000000002200222
2222222000000002250222
2002222220022000000222
2002222220022000000222
2220000000022222200002
2220000060022222200002
2220022220022222222222
2220022220722222222222
2220022000000000022222
2220022000000000822222
2220022222222220000002
2220022222222220040032
2222222222222222222222
