2222222222222222222222
2000022222222222222002
2000022222222222222002
2220022000000000000002
2220022000000000000002
2220000000022222222002
2220006000022222222502
2220022220022222222222
2220022220022222222222
2220022220000000000222
2220022220007000000222
2000000222222000000222
2000000222222000000222
2222222220000002200222
2222222220000082200222
2002222222200222200002
2002222222200222200002
2220000000000220022002
2220000400000220022002
2220022222200000022002
2220022222200000022032
2222222222222222222222
