2222222222222222222222
2000000222222222200222
2000000222222222200222
2222200220000000000222
2222200220000000000222
2222200220000220022002
2222200220000220022002
2000000222222220022002
2000000222222220022002
2220022222200220000222
2220022222200220800222
2220000000000000000222
2220000000000005006222
2220022222222002222222
2220022222222002222222
2220022002222002222002
2220022002222002222002
2000022220000002222002
2000022224000072222002
2222200002222000000002
2222200002222000000032
2222222222222222222222
