2222222222222222222222
2002222220022222222222
2002222220022222222222
2000000000000000000002
2000000000000000000402
2222222220022222222002
2222222220022222222002
2220022220000222222222
2220022220000222222222
2220022220000000000222
2220022220000000000222
2220022220022222200002
2220022220022222207002
2220000000022002200002
2220000060022002200002
2222222000022222200002
2222222000822222200002
2000000000000002222222
2000000000000502222222
2222222222200000000002
2222222222200000000032
2222222222222222222222
