2222222222222222222222
2000000002222000022002
2000000002222500022002
2002222002222002222002
2002222002222002222002
2002222002222002200222
2002222002222002200222
2222200000000002200222
2222200080000002200222
2222200222222000000222
2222200222222000000222
2000000000000222222002
2000000000700222222002
2222222222200002200002
2222222222200062200002
2220022222222002222222
2220022222222002222222
2220000000000000000002
2220000000000000000002
2220022222222222200002
2220022222222222240032
2222222222222222222222
