2222222222222222222222
2002222222222222222002
2002222222222222222002
2000000000000000000222
2000000000000000000222
2002222220022220022222
2002222220022220722222
2222222220022000000002
2222222220022000000002
2220000002222002200222
2220000002222002240222
2002222000000002200222
2002222000600002200222
2000022002200222222002
2000022002200222222002
2222222002200000022222
2222222002200000022222
2000000000022220000002
2000000085022220000002
2222222222200002222002
2222222222200002222032
2222222222222222222222
