2222222222222222222222
2000000000022222200222
2000000000022222200222
2002222220000000000222
2002222220000000000222
2000022220022222200222
2000022220722222200222
2002222000022222222002
2002222000022222222002
2222222220000000022002
2222222220040000022002
2220000000022220022222
2220008000022220022222
2220000222200000000002
2220000222200000000002
2222200222200222222002
2222200222200222222002
2000000220000002222002
2500000220006002222002
2222222002222002222002
2222222002222002222032
2222222222222222222222
