2222222222222222222222
2002222220000002200002
2002222220000002200002
2000000000000002222222
2000000000000002222222
2222222220000222200002
2222222220000222200502
2220022220022222222002
2220022220622222222002
2220022220000000000002
2220022220000000007002
2220022000022222222222
2220022000022222222222
2220000000022002200222
2220000000822002200222
2222200220022222200222
2222200220022222240222
2000000220000000000222
2000000220000000000222
2222222220022222200002
2222222220022222200032
2222222222222222222222
