2222222222222222222222
2002222222222220000002
2002222222222220000002
2000000000000000022222
2000000000000000022222
2220022002222002222222
2220022002222002222222
2220022222200000000002
2220022222200000000002
2002222220000222200222
2002222220006222200222
2220000222200002200222
2220000222200502200222
2220022220000002200002
2220022220800002200002
2220022220022002222002
2220022220022002222002
2220022000022002222002
2220022000022072222002
2220000002222002222002
2220040002222002222032
2222222222222222222222
