2222222222222222222222
2002222222200220022222
2002222222200220022222
2000000000022220000002
2000000000022220000502
2222222220022220022222
2222222220022220022222
2222222220022220022002
2222222220022220022002
2000000000000000000222
2000000000000000000222
2002222220022000000222
2002222220022060000222
2002222220022222200222
2002222220022222207222
2002200000000222200002
2002200000008222200002
2002222222200002222002
2002222222200002222402
2000022000022220022002
2000022000022220022032
2222222222222222222222
