2222222222222222222222
2002222222222002200222
2002222222222002240222
2000000000000222200222
2000000000000222200222
2002200222222222200222
2002200222222222208222
2002200000000000000002
2002200000007000600002
2002200002200222222222
2002200002200222222222
2222222222200000000222
2222222222200005000222
2220022002200222222222
2220022002200222222222
2220022220000220000002
2220022220000220000002
2220000000000000022222
2220000000000000022222
2002222222222220000002
2002222222222220000032
2222222222222222222222
