2222222222222222222222
2002222222200220022002
2002222222200220022002
2000000000022220022222
2000000000022220022222
2002222220022220022002
2002222220022220022002
2002222000000220022002
2002222000000220022002
2002222002200000000002
2002222002200000800002
2002222002222002222002
2002222002222002222002
2002200222200000022222
2002200222207000022222
2000022222222220000222
2000022222222220000222
2220022000000000022222
2224022000000500022222
2220022222222220000002
2220022222222220600032
2222222222222222222222
