2222222222222222222222
2002200220022220022222
2002200220022220022222
2002222220022220022002
2002222220022220022002
2000000000000000000002
2000008000000000006002
2002222002222002222222
2502222002222002222222
2002222002222000000222
2002222002222000000222
2002222000022222200222
2002222000022222200222
2002222000022002200222
2002222000022002200222
2002222002222222200222
2402222072222222200222
2002200000000002222222
2002200000000002222222
2002222222222000000002
2002222222222000000032
2222222222222222222222
