2222222222222222222222
2002222222222220000002
2002222222222220000002
2000000000000000022222
2000000000000400022222
2222222222222220022002
2222222222222220022002
2002200000000000022222
2002200060000000022222
2222222222222002222002
2222222222222002222002
2000000222200002222002
2005007222200002222002
2222200222222002222002
2222200222222082222002
2220000000022000000002
2220000000022000000002
2000022002222002222002
2000022002222002222002
2222222000000002222002
2222222000000002222032
2222222222222222222222
