2222222222222222222222
2000022220000222200002
2000022220000222200002
2220000000000000022222
2220000000000000022222
2220022220022222222002
2220022220822222222402
2220022220022222222002
2220022220022222222002
2220022220000000000002
2220022220000070000002
2000022220022222222222
2000022220022222222222
2002222220022222200222
2002222220022222200222
2002200000000000000222
2002200000000000006222
2002200000000222200222
2002200500000222200222
2002222222200222200002
2002222222200222200032
2222222222222222222222
