2222222222222222222222
2002222222200222200002
2002222222200222200402
2000000000000222200222
2000000000000222200222
2002222220022220000222
2002222220022220000222
2000022220022220000002
2000022220022220000002
2220000222222220022222
2220000222222220022222
2222200222200220022222
2222200222206220022222
2000000222200000000002
2000000222200000000002
2000022222200002222002
2000022222200002222502
2000000000000002222002
2000007000000082222002
2222222222222222200002
2222222222222222200032
2222222222222222222222
