2222222222222222222222
2002200220022000022222
2002200220022000022222
2002200222222002222002
2002200222222002222002
2002200000000002200002
2002200400000002200002
2000000222222222200222
2000000222222222200222
2220022222222222200222
2220022222222222200222
2220022000000000000222
2220022080000000700222
2220022002200222200002
2220022002200222200002
2220022222200002222002
2220022222200062222002
2220022222200000022002
2220022222200500022002
2220000000000222222002
2220000000000222222032
2222222222222222222222
