2222222222222222222222
2002222222222222222222
2002222222222222222222
2002200000000000000002
2002200000000005000002
2000000222222002222222
2000000222222002222222
2222200002222000022222
2222200002222000022222
2220000222222000000002
2220000222222000006002
2220022220022000000002
2220022220022070000002
2220022220000222200002
2220022220000222200002
2220022220022220000002
2220022220022220000002
2000000220000000022002
2400000220008000022002
2222200222222222222002
2222200222222222222032
2222222222222222222222
