2222222222222222222222
2002222222222220022002
2002222222222220022002
2000000000000000022222
2000000000000000022222
2222200222200222222002
2222200222208222222002
2222200222200000022002
2222200222200000022402
2000000222222220022002
2000000222222220022002
2002222220000000022002
2002222220000500022002
2002222220000220000002
2002222220000220700002
2002200222200222222002
2002206222200222222002
2002200000000222222002
2002200000000222222002
2002222222222220000002
2002222222222220000032
2222222222222222222222
