2222222222222222222222
2000000220022220000222
2000000220022220000222
2220022220022000000222
2220022220022000000222
2220022220000002200222
2220022220000072200222
2220000000022222200222
2220000000022222200222
2000022222222000000222
2000022222222000000222
2222222222222222200222
2222222222222222200222
2222200000000222200222
2222200000000222200222
2000000222200000000002
2004000222200060000002
2222222222222220022002
2222222222222220822002
2002200000000000022002
2002200000050000022032
2222222222222222222222
