2222222222222222222222
2000022220000222222002
2000022220000222222002
2220000000022220000222
2220000000022220000222
2220022002222000000222
2220022002222000000222
2220022000000002222222
2220022000000002222222
2220022222222000000002
2220022222222070000402
2220022220000002200222
2220022220000002200222
2220022220022222200222
2220022220022222200222
2220022220000222200002
2220022220008222200002
2220000220022000022002
2220000220022060022002
2002222220022000022002
2002222225022000022032
2222222222222222222222
