2222222222222222222222
2002222222222222222002
2002222222222222222002
2000000000000000000222
2000000000000000000222
2000022222222220022222
2000022222222220622222
2000000000022220000002
2000000000022220000002
2000022220022220022222
2000022224022220022222
2220022220022220022222
2225022220022220722222
2220022220022220000002
2220022220822220000002
2000022220022220000002
2000022220022220000002
2222222000022222222002
2222222000022222222002
2000000222222000000002
2000000222222000000032
2222222222222222222222
