2222222222222222222222
2000000000022222222222
2000000000022222222222
2222222220000000000002
2222222220000000000002
2002222220022222222222
2002222220022222222222
2220000000000000022222
2220000000000000022222
2222222220022222222002
2222222220022222222002
2000022220022222222002
2000022220022222222402
2002222000000000000002
2002222000008000000002
2000000002222220022002
2500000062222220022002
2222200000022220022222
2222207000022220022222
2002200222200220000002
2002200222200220000032
2222222222222222222222
