2222222222222222222222
2000022220000000000222
2000022220000000050222
2002200222222222200222
2002200222222222200222
2002222002222002200222
2002222002222002206222
2002222000000000000222
2002222000000000000222
2002222002200222200222
2002222002200222200222
2002222002222222200222
2002222072222222208222
2000022002222000000002
2000022002222004000002
2220000000022222222002
2220000000022222222002
2220000220022222222002
2220000220022222222002
2002222220000000022002
2002222220000000022032
2222222222222222222222
