2222222222222222222222
2002222222200222200222
2002222222200222200222
2000000000000222200222
2000000004000222250222
2002200002222222200222
2002200002222222200222
2002222000000002200222
2002222000000002200222
2222200222222002200222
2222200222222002207222
2220000000022000000222
2220000000022000000222
2222222220000222200222
2222222220000222200222
2002222220000000000222
2002222220600080000222
2000000000022222222222
2000000000022222222222
2222222220000000000002
2222222220000000000032
2222222222222222222222
