2222222222222222222222
2000000000000222200222
2000000000000222200222
2220022222200000000222
2220022222200000000222
2220000002222222200002
2220000002222222200002
2220022000022220000002
2220022000022220000002
2220022222222220022002
2220022222222220822002
2220022222200000022002
2220022222200000022002
2220000002222222200002
2220000002222222200002
2222222002222222222222
2222222062222222222222
2000000000000000000222
2005000000007000040222
2222222222222222200002
2222222222222222200032
2222222222222222222222
