2222222222222222222222
2000000222200222222002
2000000222200222222002
2222200000022000000222
2222200000022000000222
2002222002222002200222
2002222002222002200222
2220022002222002222222
2220022072222002222222
2220000000000000000002
2220000000000000000502
2222222222222220022002
2222222222222220022002
2000022220000000022222
2004022220000060022222
2220022220000222200222
2220022220008222200222
2220000000000000000222
2220000000000000000222
2220022222222222200002
2220022222222222200032
2222222222222222222222
