2222222222222222222222
2000000220022222222222
2000000220022222222222
2222200222200000000002
2222200222200000000002
2000000002222002222222
2000008002222002222222
2220022002222002200002
2220022002222002200002
2222222002222002222002
2222222002222502222002
2000022000000002200222
2000022060000002200222
2220022222222002200222
2220022222222002200222
2220022222222000000222
2220022222222000000222
2220000000000000000002
2224007000000000000002
2002222000022222222002
2002222000022222222032
2222222222222222222222
