2222222222222222222222
2000022220022220022002
2000022220022220022002
2220022220022220022002
2220022220022225022002
2220000000022220022222
2220000000022220022222
2220022220022000000002
2220022220022060000002
2220022220022220022222
2220022220022220022222
2220022220000000000002
2220022220007000000002
2220022220000000000002
2220022220000000000002
2220022222200002222222
2220022222200082222222
2220022002222002222222
2220022002222002222222
2220000002222000000002
2220000402222000000032
2222222222222222222222
