2222222222222222222222
2002222222222222222002
2002222222222222222002
2000000000000000000002
2000000000000000000002
2002222222200222222222
2002222222200222222222
2002222002200222200222
2402222002200222200222
2220022000000000000002
2220022000000000000002
2222200002222220022222
2222200002222220022222
2002200222222220000222
2002200222222220006222
2000000000000222222222
2000000000008222222222
2002222220022222222002
2002222220722222222002
2002222000000000000002
2502222000000000000032
2222222222222222222222
