2222222222222222222222
2002222000000000022002
2002222004000000022002
2000022222200220022002
2000022222200220022002
2000000002222220022002
2000000062222220022002
2002222002222000000222
2002222002222000000222
2002222002222220022222
2002222002222220022222
2002222000000220000002
2002222080050220000002
2222222002222222200222
2222222002222222200222
2220022002222000000222
2220022072222000000222
2220000000000002200222
2220000000000002200222
2002222222222222200002
2002222222222222200032
2222222222222222222222
