2222222222222222222222
2000000000000222200222
2000000000000222200222
2220022222222002200222
2220022222222002200222
2220000000022222200222
2220000000622222200222
2222222220000000000002
2222222220000000000002
2002222220022222200222
2002222220022222200222
2000000000022002200222
2000000400822002200222
2222222220022220000222
2222222220022220000222
2222200000022222200002
2222200070022222200002
2000000220022002222002
2000000220022002222002
2002222220000002222002
2002222220000502222032
2222222222222222222222
