2222222222222222222222
2002222000000220022222
2002222004000220022222
2000000002200222200002
2000000002200222200002
2220022222222222200222
2220022222222222200222
2220000000000000000222
2220008000000000000222
2002222002200222200222
2002222002200222200222
2220000002200002200222
2220000002200002200222
2220022222200002200222
2220022222200002206222
2000022222222002222222
2500022222222002222222
2220000000022000000002
2220000000022070000002
2220022220022222222002
2220022220022222222032
2222222222222222222222
