2222222222222222222222
2002222000022222200002
2002222000022222200002
2000000002222000022222
2000000002222000022222
2000022222222220000002
2000022222222220000002
2220000000000220022222
2220000070000220022222
2222200222200000000222
2222200222200000008222
2000000220022222200222
2000000220022222200222
2002222002200222200222
2002222002250222200222
2222200222200222200222
2222200222200222206222
2220000000000000000222
2224000000000000000222
2220022222222222200002
2220022222222222200032
2222222222222222222222
