2222222222222222222222
2002200222222000022222
2002200222222004022222
2002200000022000000002
2002250000022000000002
2002222220022002222222
2002222220022072222222
2000022220000000000222
2000022220000000800222
2220022220000002200222
2220022220000062200222
2220022220022002222002
2220022220022002222002
2220022222222002222002
2220022222222002222002
2220022002222000000222
2220022002222000000222
2220022000000002200222
2220022000000002200222
2220000002222222200002
2220000002222222200032
2222222222222222222222
