2222222222222222222222
2000000222200002222002
2000000222200002222002
2220000222200002200222
2220000222200002200222
2220000000000000000222
2220000080000000000222
2220022222222222222222
2220022222222222222222
2220022222222220000002
2220022222222220000402
2220000000000220022222
2220000000000220722222
2000022222200000000222
2000022222206000000222
2222200000000222200222
2222250000000222200222
2220000002200222200222
2220000002200222200222
2220022222200222200002
2220022222200222200032
2222222222222222222222
