2222222222222222222222
2000000222222222222002
2000000222222222222502
2002200000000000000002
2002200000000000000002
2002200002222220022222
2002200002222220022222
2002222222200220000222
2002222222206220000222
2000022222200000000222
2000022222200000000222
2220022000000220000002
2220022004000220000002
2220022222222220022222
2220022222222220022222
2220022220000000000222
2220022220000000000222
2220022220022002200222
2220022220822002207222
2220022220022222200002
2220022220022222200032
2222222222222222222222
