2222222222222222222222
2002222222200000000002
2002222222200000000002
2000000000000222222002
2000000000000222222502
2220022222222222200002
2220022222222222200002
2220022220000002222222
2220722220008002222222
2220000000022002200222
2220006000022002200222
2220022222222000000222
2220022222222000000222
2220022222222222200002
2220022222222222200002
2220000000000222222002
2220000000000222222002
2220022222200220000002
2220022222200220040002
2220022002200222222002
2220022002200222222032
2222222222222222222222
