2222222222222222222222
2002222222200222222222
2002222222200222222222
2000000000000220000002
2000000000000220000002
2002222220022220022222
2502222220022220022222
2002222220000000000222
2002222220006000700222
2222200000022222200222
2222200000022222200222
2000022220022222222002
2000022220022222222002
2000022220022000000222
2000022220022000040222
2222200220022002222222
2222200220022002222222
2000000000000000000002
2000000000000080000002
2222222222200002222002
2222222222200002222032
2222222222222222222222
