2222222222222222222222
2000000222222222222222
2000000222222222222222
2222200220000000000002
2222200220000000000002
2222200000022222222002
2222200000022222222002
2002222220022000000002
2002222220022000008002
2002222000022000000222
2002222000022004000222
2000000000022002200222
2000000000022002200222
2222222000022222200002
2222222000722222200002
2222222220022222222002
2222222220022222222002
2000000000000000022002
2000000000006500022002
2222222002222222222002
2222222002222222222032
2222222222222222222222
