2222222222222222222222
2002222222222222222002
2002222222222222222002
2002200000000000000222
2002200000000000000222
2000000002222002222222
2000000072222002222222
2002200002222002222002
2002200002222002222002
2222200222200002200002
2222206222200002240002
2222200222200222222002
2222200222208222222002
2002200222200000022002
2002200222200000022002
2000022220022220022002
2000022220022220022002
2220000000000000000002
2225000000000000000002
2220022222222222222002
2220022222222222222032
2222222222222222222222
