2222222222222222222222
2002222220022220000002
2002222220022220050002
2000000000022000022222
2000000000022000022222
2000022222222002222222
2000022222222002222222
2220022222222002200002
2220022222222082200002
2220000000000000000002
2220000060000000000002
2220022222222222222002
2220022222222222222002
2220000000022220022222
2220000000722224022222
2220022220022220022222
2220022220022220022222
2220022000000220022002
2220022000000220022002
2220022222200000000002
2220022222200000000032
2222222222222222222222
