2222222222222222222222
2000000000000000000222
2000000000000000040222
2220022220000222222222
2220022220000222222222
2220022222222222222002
2220022222222222222002
2220022002222000000002
2220022002222000000002
2220022002222000022222
2220022002222000822222
2220022002222000022002
2220022002222000022002
2220000000022220000222
2220000000022220000222
2220022220022000022222
2220022220622000722222
2000022220000000000002
2500022220000000000002
2222200002222222222002
2222200002222222222032
2222222222222222222222
