2222222222222222222222
2002222222222222222222
2002222222222222222222
2002200000000000000002
2002200000000000000002
2002222222222002222002
2002222222222002222002
2000022222200002222002
2000022222200002222002
2002222000000222222002
2002222000000222222502
2000000002222220022222
2000000002222220022222
2002200002222220022002
2002200002222220022002
2002200000000220000222
2002200060000220000222
2002200222200000000222
2002207222208400000222
2222200222200222200002
2222200222200222200032
2222222222222222222222
