2222222222222222222222
2000022222222222200222
2000022222222222200222
2002222000000002200222
2002222000000002200222
2002222220022222200222
2002222220022222200222
2000000000000000000222
2000000080000000000222
2002222220022002200002
2502222220022002200002
2002222000022002222002
2002222000022002222002
2222222002222222200002
2222222002222222200002
2220022002200002200222
2224022072200002200222
2220000000022002200222
2220000000622002200222
2002222222222000000002
2002222222222000000032
2222222222222222222222
