2222222222222222222222
2002222220000222222222
2002222220000222222222
2000000002222000000002
2000000002222000000002
2002222222222222200222
2002222222222222200222
2000022000000000000222
2000022000000000000222
2220000002200222200222
2220000002200222200222
2220022222200222200222
2220022222208222200222
2000000002222002200222
2000000002222062200222
2002222000000222200222
2002222004000222200222
2222200002200222200002
2222200002207222200002
2002200222200002222002
2002200222200502222032
2222222222222222222222
