2222222222222222222222
2002222222200000000002
2002222222200400000002
2000000002222222222002
2000000002222222222002
2002200002200220000002
2002200072200220000002
2222222000022220022222
2222222000022220022222
2220022002222220000222
2220022002222220000222
2220022000000222200222
2220022000000222200222
2220022002200222200222
2220022002200222200222
2220000002200222200222
2220000082200222200222
2222200222200000000002
2222206222200000000002
2000000222200222222002
2500000222200222222032
2222222222222222222222
