2222222222222222222222
2002222000000000000222
2002222000040000000222
2000022220022222200222
2000022220022222200222
2220022220022222222002
2220022220022222222002
2220000000000000022222
2220000000008000022222
2000000002222220000002
2000000002222220006002
2002200222200220022222
2002250222200220022222
2222200222200000000222
2222200222200000007222
2222200222222222200222
2222200222222222200222
2000000000022222200002
2000000000022222200002
2222222220000002222002
2222222220000002222032
2222222222222222222222
