2222222222222222222222
2000022222222222222222
2000022222222222222222
2220000000000000000002
2220000000000000000002
2220022220022220022222
2220022224022220722222
2222222000022220022002
2222222000022220022002
2002222222222220022222
2002222222222220822222
2000000222200000000002
2000000222200500000002
2222200000000000022002
2222200000000060022002
2000000222200222222222
2000000222200222222222
2222222000000000000222
2222222000000000000222
2000022002222222200002
2000022002222222200032
2222222222222222222222
