2222222222222222222222
2002222000000222222222
2002222000000222222222
2000000002200220000002
2000000002208220000402
2220022002200222200002
2220022002200222200002
2220022002200222200222
2220022072200222200222
2000022002222222200222
2500022002222222200222
2220022000000000000222
2220622000000000000222
2220022002200220000222
2220022002200220000222
2220022002222222200222
2220022002222222200222
2220022002222000000222
2220022002222000000222
2002222000022222200002
2002222000022222200032
2222222222222222222222
