2222222222222222222222
2002222220022222200222
2002222220022222200222
2000000000022000000222
2000000000022000000222
2002222002222000000002
2002222002222000000002
2002222002222000022002
2002222002222000022002
2002222000000002222002
2002222000000002222002
2222222222200000022222
2222222222200000622222
2220000000000220000222
2220700000000220008222
2220022222222220022222
2220022222222220022222
2220022222222000000002
2225022222222000000402
2220000000022222222002
2220000000022222222032
2222222222222222222222
