2222222222222222222222
2000000002222222222222
2000000002222222222222
2220022002200000000002
2220022002200000000002
2220022002222002200222
2220022002222002200222
2220022000000002200222
2220022000000002207222
2220000222222222200222
2220000222222222200222
2222200000022222200222
2222200000022222240222
2000000220000000022222
2500000220006000822222
2002200222200220000002
2002200222200220000002
2002200222200222222002
2002200222200222222002
2002222002200220022002
2002222002200220022032
2222222222222222222222
