2222222222222222222222
2002222222200000000222
2002222222200000000222
2002200002200222200222
2002200002200222240222
2000022000000222200002
2000022000000222200002
2220022220022222222222
2220022220022222222222
2220000000000000000222
2220000085000000000222
2220022222200222200222
2220022222200222207222
2220000222200222200222
2220000222206222200222
2000022002200222200222
2000022002200222200222
2002222222222220000222
2002222222222220000222
2000000000022220000002
2000000000022220000032
2222222222222222222222
