2222222222222222222222
2000000222200222200222
2000000222200222200222
2222200222200222200222
2222200222200222200222
2220000222200222200222
2220000222200222200222
2000022220000000000222
2500022220000070000222
2220000000000222222222
2220000000000222222222
2220022222200222222002
2220022222200222222402
2220022222200000022002
2220022222206000022002
2000022000000000000002
2000022000000000008002
2002222002222220022002
2002222002222220022002
2002222000022220022002
2002222000022220022032
2222222222222222222222
