2222222222222222222222
2002222222222222200002
2002222222222222200002
2000000000000000000222
2000000000000000000222
2220022000022222200222
2220022070022222200222
2220022222222222200222
2220022222222222200222
2220022220000000000002
2220022220800000000502
2220022220022000022002
2220022220022000022002
2220022220022002222002
2220022220022002222002
2000022002200002222222
2000022002200062222222
2222222222222002200222
2222222222222002240222
2002200000000000000002
2002200000000000000032
2222222222222222222222
