2222222222222222222222
2000000002222222200222
2005000002222222200222
2002222000000002200222
2002222000000002200222
2000000220022000000222
2000008220022000000222
2002222220022222200222
2002222220022222200222
2222222220022222200222
2222222220022222200222
2220000000000002222002
2220000000007002222002
2002222002222000000222
2002222002222400006222
2002200002222002222222
2002200002222002222222
2220000222222002222002
2220000222222002222002
2220022220000000000002
2220022220000000000032
2222222222222222222222
