2222222222222222222222
2002222222222002222002
2002222222222002222002
2000000000000002222002
2000000005000002222002
2222222002222220000002
2222222002222220000002
2222222002222220022222
2222222002222220022222
2000000000000000000002
2000000000000000008402
2220022222200002222002
2220022222207002222002
2220022220022002200002
2220022220022002200002
2220022002222000022002
2220022002222060022002
2220022002222002222002
2220022002222002222002
2220000002222002222002
2220000002222002222032
2222222222222222222222
