2222222222222222222222
2002222002222002200222
2002222502222002200222
2000000000000222200222
2000000000000222200222
2222222220000222200222
2222222220000222200222
2220022220000000000002
2220022220000000000002
2220022220022220000002
2220022220022220800002
2220000000000220022002
2220000000000220022002
2220022222222222222002
2220022222222222222002
2220022222200000022002
2220022222200070022002
2220000000000222222002
2220000000600222222402
2220022222200220022002
2220022222200220022032
2222222222222222222222
