2222222222222222222222
2000022222222220000222
2000022222222220000222
2220022000000000022222
2220022000000500022222
2220022002222000022002
2220022002222000022002
2220000002222002222002
2220000002222002222002
2220022222222000000002
2220022222222000008002
2220022220000002200002
2220022220000002200002
2220022220000002222002
2220022220700062222002
2220022222200002222002
2220022222240002222002
2220022000000002222002
2220022000000002222002
2002222002222220022002
2002222002222220022032
2222222222222222222222
