2222222222222222222222
2002222220000220000222
2002222220000220000222
2000000002200220000222
2000000002200220000222
2002222002222220022222
2002222062222220022222
2222200000000000000002
2222200005007000000002
2222222222222220022222
2222222222222220822222
2000000222222220000222
2000000222222220000222
2002200000000222200222
2402200000000222200222
2222222222200002200222
2222222222200002200222
2220022222200000000002
2220022222200000000002
2220000000000222222002
2220000000000222222032
2222222222222222222222
