2222222222222222222222
2002222222222002222222
2002222222222002222222
2000000000000002200002
2000000000000002200002
2000000000022222200222
2005000000022222200222
2002222002222222200222
2002222002222222200222
2000022000000000000222
2000022000007000000222
2220022222222002200002
2220022222222002206002
2222222002200002222222
2222222002200002222222
2000000222200222222222
2000000222208222222222
2000000000000000000002
2000000400000000000002
2222222222222222222002
2222222222222222222032
2222222222222222222222
