2222222222222222222222
2002222222222222222222
2002222222222222222222
2000000000000000000002
2000000000000000000002
2222222220022222222002
2222222220022222222002
2002222000000000022222
2002222000000000622222
2220000002222220022002
2220007002222225022002
2220022002222220022222
2220022082222220022222
2000022000000222222002
2000022000000222222402
2222222002200220000002
2222222002200220000002
2220022002200220022002
2220022002200220022002
2220000002200000022002
2220000002200000022032
2222222222222222222222
