2222222222222222222222
2002222222222222222222
2002222222222222222222
2000000000000000000002
2000000000000000000002
2222222222222002222002
2222222222222002222002
2002222222222002222002
2002222222222002222402
2220000000022000000222
2220000000022070000222
2220000000000002200222
2220006000000002200222
2222200002222002200222
2222200002222002200222
2000000002222222200222
2000000082222222200222
2000000000000222200222
2000000000000222200222
2002222222222002200002
2502222222222002200032
2222222222222222222222
