2222222222222222222222
2002222222222222222222
2002222222222222222222
2000000000000000000002
2000000000000400000002
2002222222222222222222
2002222222222222222222
2000000222200000000222
2000000222200000000222
2002200222200222200222
2002200222200222200222
2002200220000002200222
2002200220000002200222
2222200000022220000002
2222200000622220007002
2220000002222002222002
2220000082222002222002
2220022000000222222002
2220022000050222222002
2002222002222220000002
2002222002222220000032
2222222222222222222222
