2222222222222222222222
2002222222222222200222
2002222222222222250222
2000000000000002200222
2000000000000002200222
2000022222222220000222
2000022222222220007222
2220022222222000022222
2220022222222000022222
2220022000000002222002
2220022000000002222002
2220000002222000000002
2220000002222000000002
2220022222200000022002
2220022222200000022002
2220022220000000022002
2220022220600000022402
2220022000022000022002
2220022000022080022002
2220022220022222222002
2220022220022222222032
2222222222222222222222
