2222222222222222222222
2000000002222222222002
2000000002222222222002
2220022222200000000222
2220822222200000000222
2220000000000222222222
2220000000600222222222
2220000222200002222002
2220000222200002222002
2220022222222222222002
2220022222222222222002
2000000000000000000002
2000000000000000000002
2222222000022002222222
2222222000022002222222
2220022002222000022222
2220022002222000022222
2000000002222220022002
2500000002222220022002
2222222222200000000002
2222222222207400000032
2222222222222222222222
