2222222222222222222222
2000022222222222222222
2000022222222222222222
2002222000000000000002
2002222000000000000002
2002222002222222200002
2002222002222222200002
2000000000000002222222
2000000000000002222222
2002222222222002222222
2002222222222002222222
2000022222222222200002
2000022222222222200002
2002222000000002222002
2002222000800002222002
2000000002222002222002
2000000002222002222402
2002200000022000000002
2002200500722000600002
2002222222200222222002
2002222222200222222032
2222222222222222222222
