2222222222222222222222
2002222220022002222002
2002222220022002222002
2000000002222000000222
2000000002222400000222
2222222002222220022222
2222222002222220022222
2220000000000000000002
2220006000000000000002
2222200222222222222222
2222200222222222222222
2000000002222222222002
2000000082222222222002
2220022002200000000222
2220022002200000000222
2220022002200222200222
2220022072200222200222
2002222000000002200002
2002222000000502200002
2000000222222002222002
2000000222222002222032
2222222222222222222222
