2222222222222222222222
2002222222200222200002
2002222222200222200402
2000000002200222200222
2000000502200222200222
2220022222200222200222
2220022222200222200222
2220000222200000000222
2220000222200000000222
2222200220022000000002
2222200220022080000002
2000000222222000000222
2000000222222000700222
2002200000022222200222
2002200000022222206222
2002222002222222200222
2002222002222222200222
2000022000000000000222
2000022000000000000222
2222200222222222200002
2222200222222222200032
2222222222222222222222
