2222222222222222222222
2000022222200220022222
2000022222200220022222
2220000000000222200002
2220000000000222200002
2220022222200000000222
2220022222200000006222
2220022220000222200222
2220022220008222200222
2220022000000220000002
2220022000000224000002
2220022000000222222222
2220022000700222222222
2220022002222222222222
2220022002222222222222
2220022002200000000002
2220022002200000000002
2000022000000002222002
2000022000050002222002
2222200222222220022002
2222200222222220022032
2222222222222222222222
