2222222222222222222222
2000000222222220000222
2000000222222220000222
2220000000000000000222
2220000000000000000222
2220022222222222200222
2220022222222222200222
2220022002222000000222
2220022002222000800222
2220000002222000000222
2220000502222000000222
2220022220000002200002
2220022220000002200002
2220000222222002200002
2220000222222002200002
2222222222222002200222
2222222222222002200222
2000000000000002200222
2400007000006002200222
2222222220022222200002
2222222220022222200032
2222222222222222222222
