2222222222222222222222
2002222222222220022002
2002222222222220022402
2000000000000002222002
2000000000000002222002
2222200002200000022002
2222200002200080022002
2220000222200220000002
2220000222200220000002
2000000222200222200222
2000000222200222200222
2222200222222002200222
2222200222222072206222
2220000000022222200222
2220000000022222200222
2220022220022000000222
2220022220022005000222
2220022000000220022222
2220022000000220022222
2220022222222220000002
2220022222222220000032
2222222222222222222222
