2222222222222222222222
2000022220022220000222
2000022220022220040222
2220000002200000000222
2220000002200000000222
2220022222200222200222
2220022222200222207222
2000022002200222200222
2000022002200222200222
2220022000022220000002
2220022000022220000002
2220022222222000022222
2220022222222000022222
2220000000022220000222
2220006000022220000222
2220022222222220000002
2220022222222220000502
2220022000000000022002
2220022080000000022002
2220000002222222222002
2220000002222222222032
2222222222222222222222
