2222222222222222222222
2000022220022220022222
2000022220022220022222
2220022220022220022002
2220022220022220022002
2220000000000000000002
2220000000000000000002
2220022002222220022222
2220022002222220022222
2220022002222220000222
2220022002222220000222
2222222002200220000002
2222222002200220007002
2002222000000222222002
2002222060000222222002
2000022220022220000002
2500022220022224000002
2220000000022220022222
2220008000022220022222
2220022220022220000002
2220022220022220000032
2222222222222222222222
