2222222222222222222222
2000000222200222222222
2000000222200222222222
2222200000000220000002
2222200000000220000002
2220000002222220022222
2220000062222220022222
2000000000022220022222
2000000400022220022222
2220000000022220000002
2220008000722220000002
2220022002222222200222
2220022002222222250222
2222222000000002200222
2222222000000002200222
2002222222200222200222
2002222222200222200222
2000000000000000000222
2000000000000000000222
2222222222222222200002
2222222222222222200032
2222222222222222222222
