2222222222222222222222
2000000222222222200222
2000000222222222200222
2220022220000002200222
2220022220000002200222
2220022222222000000222
2220022222222500000222
2220022002200002200222
2220022002200002200222
2220000000000222200222
2220000000000222206222
2000000222222222222222
2000000222222222222222
2002222222222000000002
2002222222222000000002
2000000000000000022222
2004000080000000722222
2000000222200220022222
2000000222200220022222
2222222220000220000002
2222222220000220000032
2222222222222222222222
