2222222222222222222222
2000000220022220000222
2000000220022220000222
2002200222200222200222
2002200222200222200222
2002200000000000000002
2002200000000000000002
2222200222200222222222
2222206222200222222222
2220000222200222222002
2220000222200222222002
2000022000000000000222
2004022000000005000222
2222222002222002222222
2222222002222002222222
2222222002222000000002
2222222002222000008002
2000000002222002222002
2000000072222002222002
2222222220000002222002
2222222220000002222032
2222222222222222222222
