2222222222222222222222
2002222220000222200222
2002222220000222200222
2000000002222000000222
2000000002222000050222
2222222000022002200222
2222222080022002200222
2222200220022222200222
2222206220022222200222
2000022220000222200222
2000022220000222200222
2002222000022222200222
2002222070022222200222
2002222002222000000222
2002222002222000000222
2000000000022002200002
2000000000022002200002
2002200220000002222002
2002200220000002222002
2002200222222220022002
2402200222222220022032
2222222222222222222222
