2222222222222222222222
2000000222222222222002
2000000222222222222002
2222200220000000000222
2222200220000000000222
2220000000022222200222
2220008500722222200222
2000000000000222200222
2000000000000222200222
2222222002222222200222
2222222002222222200222
2220000002222000000222
2220040002222000000222
2220022222200002200222
2220022222200002206222
2220000220022222200002
2220000220022222200002
2222222222222222222002
2222222222222222222002
2000000000000000000002
2000000000000000000032
2222222222222222222222
