22222222222222222222222222
20000002200002222222200222
20000002200002222222200222
22200002200222200000000222
22200002200222200000000222
22200222200220022222200222
22200222200220022222200222
20000002200222222222200222
20000002200222222222200222
22222000000000000000000222
22222000000000000000600222
22200002222002222222200222
22200002222002222222200222
22200222200000022222200222
22200222200000022222208222
20000222200220000002200222
20007222200220000002240222
20000222200222222222200222
20000222200222222222200222
20000002222220022220000222
20000002222220022220000222
20000002222220022220022222
20000002222220022220022222
20000000000000022220000002
20000000050000022220000032
22222222222222222222222222
