22222222222222222222222222
20022220000000022222222002
20022220000000022222222002
20000000022222222000000222
20000000022222222000000222
22222002222222222222200222
22222002222222222222200222
22200000000000000000000222
22200000007000000000000222
22200222222222200222222222
22200222222222200222222222
20000222222222200222222002
20000222222222200222222002
22222220000000000000022002
22222220000080000000022002
22200000022220022000000002
22200000022220022000000002
22222220000220022220022222
22222220000225022220622222
20000222200222222000000222
20040222200222222000000222
20000222222222222002222222
20000222222222222002222222
20000000000000000000000002
20000000000000000000000032
22222222222222222222222222
