22222222222222222222222222
20000000000002222000000002
20000000000002222000000002
20022000022222222002222002
20022000022222222002222002
20022220022220000002222002
20022220022220000002222502
20000002222220022222222222
20000002222220022222222222
22222000000220022220000222
22222000000220022220000222
22200002222220000002200222
22200002222220000002200222
22200000022220022222200222
22200000022220822222206222
22222220022220022220000222
22222220022220022220000222
20000000022220022220022222
20000000022220022220022222
22222220000000000000000002
22222220000000007004000002
22222220022220022222222002
22222220022220022222222002
20000000022220022000022002
20000000022220022000022032
22222222222222222222222222
