22222222222222222222222222
20000002200222200000000002
20000002200222200000000002
20022002222000022222222222
20022002222000022222222222
22222002222002222000000002
22222002222002222000000002
22222002222002222002222222
22222002222002222002222222
20000000000000022000000002
20000060000000022004000002
20022002222220022002222002
20022002222220022002222072
22222002222222222002222222
22222002222222222002222222
22200000000002222000000222
22200000000002222500000222
20000222222000022222200222
20000222222000022222200222
20022222222000022220000002
20022222222000022220000002
22222000000000000000022002
22222000800000000000022002
20000222222222200222222002
20000222222222200222222032
22222222222222222222222222
