22222222222222222222222222
20000000000000022222222222
20000000000000022222222222
20022222200220000000000002
20022222200220000000000002
20022220000222222222200222
20022220000222222222200222
20022222222220000002200222
24022222222220000062200222
20022000022222222002200222
20022000022222222002200222
20022002222002200000000222
20022002222002200000050222
20000000000002200220000002
20000000800002200220000002
20022222222002222220022222
20022222222002222220022222
22222002222002200220000222
22222002222002200220000222
22200220000002222002200222
22200220000002222072200222
22200220022000000222200222
22200220022000000222200222
22200000022222222220000002
22200000022222222220000032
22222222222222222222222222
