22222222222222222222222222
20022222222222200000000002
20022222222222200000000002
20000000000000000222222222
20000000000000000222222222
22222222200222200220000002
22222222200222200220000002
22200000000002222222222222
22200000000002222222222222
20022000022222200000000002
20022000022222207000000402
22222220000222200222222222
22222220000222200222222222
20000000022222200222222222
20000000022222200222222222
22222002222000000000000002
22222002222000000000000002
20000002222222222220000222
20000002222222222220000222
22222000000002222000000222
22222000800002222000050222
20022002222000000002200222
20022062222000000002200222
20022002222002222222200002
20022002222002222222200032
22222222222222222222222222
