22222222222222222222222222
20022000000222222002222002
20022000000222222002222002
20022222200000000002222002
20022222240000000002222002
20022222222002222002222002
20022222222002222002222002
20000000000000022002222002
20000000007000022002222002
22222222222222222002200002
22222222222222222002200002
22222222222222222000000222
22222222222222222000000222
20000000000000000002222222
20000000000000000002222222
20022220022222222002222002
20022220022222222002222002
20000222222002222000000002
20000222222002222000000002
22222222200000000002222222
22222222200000000062222222
20000000000000000002222222
25000000000000000002222222
22222222200002222000000002
22222222200082222000000032
22222222222222222222222222
