22222222222222222222222222
20000002222002200222200222
20000002222002200222200222
22200222200222200002200222
22200222206222200002200222
22200000000222222000000222
22200000000222222000000222
22200220022220022222200222
22200224022220022222200222
22200220022220000000000222
22200220022220000000000222
22200000000222200222222002
22200000000222200222222002
22200222200222200002222222
22200222200222200002222222
20000222200000000000000002
20000222207000000000000002
20000222222220022222222002
20000222222220022222222502
22222000000000022222222002
22222000000000022222222002
20022000000000000000022002
20022000000000000000822002
20022002222222222222222002
20022002222222222222222032
22222222222222222222222222
