22222222222222222222222222
20022220000000000220022002
20022220000000000220022002
20000002222220000220022222
20000002222220000220022222
22200222200002222220000002
22207222250002222220006002
22200222200222200002222002
22200222208222200002222402
22200000000222222002222002
22200000000222222002222002
22222220022220000000022002
22222220022220000000022002
20022220000222200220000002
20022220000222200220000002
20022220022220000222200222
20022220022220000222200222
20022220022220000222200222
20022220022220000222200222
20022220022220000002222222
20022220022220000002222222
20000000000000022000000002
20000000000000022000000002
22222222222220022222222002
22222222222220022222222032
22222222222222222222222222
