22222222222222222222222222
20000222222222222222200222
20050222222222222222200222
22200000000000000002200222
22200000000000000002200222
22200222222222222000000222
22200222222222222000000222
22200000022222200002222222
22200080022222200002222222
22200222222002200000000002
22200222222002200000000002
20022000022000000222222002
20022000022000000222222002
20022222222220000222222002
20022222222220000222222002
22200000000220022220000002
22200000000220022220000002
22222220022220000222200222
22222220022220000222200222
20000000000000000002200222
20000000000000000072200222
22200222222220000002200222
22240222222220006002200222
22200000022220022222200002
22200000022220022222200032
22222222222222222222222222
