22222222222222222222222222
20022220000222200222200222
20022220000222200222200222
20000002222002200222200222
20000002222002200222200222
20022222222000000222200222
20022222222000000222250222
20000000000002222222200002
20000000000402222222200002
22222222200222200002222002
22222222200222208002222002
22200220000222222002222002
22200220000222222002222002
20022220000000000000000002
20022220000000700000000002
20000222222002222220022222
20000222222002222220022222
22200222222002200220000222
22200222222002200220000222
22200000000002222222200222
22200000600002222222200222
22222000022000000002200002
22222000022000000002200002
20000002222002222002222002
20000002222002222002222032
22222222222222222222222222
