22222222222222222222222222
20000222222000000222200222
20000222222000000222200222
22200000022002222222200222
22200000022002222222200222
22222002222002222000000002
22222002222002222000000002
20022002222002222002222002
20022002222002222002222002
20000002222002222002222002
20007002222002222002222002
20022000000002200002222002
20022000000002200002222002
22222002200222200222200222
22222002200222200222208222
22222002200000000000022222
22222002200000000000022222
20022220000222222220000002
20022220000222222220000002
20000000000220022222200222
20000000000220022222200222
22222002200222200000000222
22222502206222200004000222
22200002222000022222200002
22200002222000022222200032
22222222222222222222222222
