22222222222222222222222222
20022222222220000000000002
20022222222220000000000502
20000000000000022222222002
20000000000000022222222002
20022002222000022222222222
20022002222000022222222222
22222002222000000000000002
22222002222080000000000002
22222000022222222222200222
22222000022222222222200222
20000002222220000002200222
20000062222220000002200222
22222222200000022220000222
22222222200000022220000222
22200002222220022222200222
22200002222220022222200222
22200222222000000000000002
22240222222000000000000002
22200220000000022002222222
22200220000000722002222222
20000000022220022000000222
20000000022220022000000222
22222222222000022222200002
22222222222000022222200032
22222222222222222222222222
