22222222222222222222222222
20000002222220000222200222
20000002222220000222200222
22222002200000000222200222
22222002200000000222200222
22200000000222200002200222
22200000000222200002200222
22222222222220000002200222
22222222222224000002200222
20000222222220022002200222
20006222222220022002200222
22200000000222222002200002
22200500000222222002200002
22200222222222200002200222
22200222222222200002200222
22200222200000000002200222
22200222200000000002200222
22200222222000022222200222
22207222222080022222200222
22200000000002222000000222
22200000000002222000000222
20022222200000000002222222
20022222200000000002222222
20000220000222222000000002
20000220000222222000000032
22222222222222222222222222
