22222222222222222222222222
20000222222002200002222222
20000222222002200002222222
22200000000222222000000002
22200000000222222000000002
22200002200000000002222002
22200002200080000002222002
20022002222222222000022222
20022002222222222000022222
22222002222000000000022002
22222002222000000000022002
20022002222002222220000222
25022002222002222220040222
20000220022002222220000222
20006220022002222220000222
22200220022000000222200222
22200220022000000222200222
22200222222002222222200222
22200222222002222222200222
22200000000002222000000222
22200000000002222000007222
20022220022002222002200222
20022220022002222002200222
20000220022002222002200002
20000220022002222002200032
22222222222222222222222222
