22222222222222222222222222
20022222222220000002222002
20022222222220000002222002
20000000000222222002200222
20000000000222222002200222
22222002200000022002200222
22222002200000022002200222
22200002200220000000000222
22200002200220007000600222
22200222200222200222222002
22200222200222200222222002
20000222222222200220022222
20000222222222200220022222
20022220000000000000000002
20022220000000000000008002
20022220000000022220022222
20022220000000022224022222
20022220022220022220000222
20022220022220022220000222
20022222222000000222222222
20022222222500000222222222
20000002222002200222222002
20000002222002200222222002
22222002200222200000000002
22222002200222200000000032
22222222222222222222222222
