22222222222222222222222222
20022222200002222222200222
20022222200002222222200222
20000002200222200002200222
20000402200222200002200222
20022222200222222000000002
20022222200222222000000002
20000000000000022220022222
20000000007000022220022222
22222220022222222000022222
22222220022222222000022222
22200000022222222000000002
22200000022222222000000502
22200220000000022000022002
22200220000000022000822002
22200220000000000000022222
22200220000000000000022222
20000222222222200002200222
20000222222222200002200222
20022222222222200222200222
20022222222222200222200222
20000000000002200000000002
20000000000002200000000002
22222222222222200222222002
22222222222222206222222032
22222222222222222222222222
