22222222222222222222222222
20022220022000000002222222
20022220022000000002222222
20000002222002200000000002
20000002222002200000000002
20022002222002222220000222
20022002222002222220000222
20022000000002222220000222
20022000000002222220000222
22222002200000000222222002
22222002200000000222222002
22222002222222200222200222
22222002222222250222200222
20022000022220000000000222
20022000022220000000000222
20000000022220022002200002
20006000022220022002200002
22222220022002222002222002
22222220822072222002222002
22222220022222200002222002
22222220022222200002222002
20000000000002200002222002
20000000000002200402222002
22222222222220022222200002
22222222222220022222200032
22222222222222222222222222
