22222222222222222222222222
20022222222000022220022222
20022222222000022220022222
20000000022220000220000002
20000000022220000220000402
22200222222222200000022222
22200222222222200000022222
22200000000002222002222222
22200000000002222002222222
22200222222000000000000002
22200222222000000000000002
20022220022222200220000002
20022220022222200220000002
22222220022222200220022002
22222220022222200220022002
20000000000000000222222002
20000000000000000222222002
22222222222002222222222002
22222222222002222222222002
22200222222222222000000002
22206222222222222000000002
22200000000000000002200002
22200000000000000002208002
20000222222222200002222002
25007222222222200002222032
22222222222222222222222222
