22222222222222222222222222
20022222200222222220000222
20022222200222222220000222
20000000000220000220022222
20000000000220000220022222
22222222200000000000000002
22222222200000000070000002
22200000000222200222222002
22200000000222200222222002
22200222222220000222200002
22200222222225000222200002
22200002222220022222200222
22200002222220022222200222
22200000000222222000000222
22206000000222222000000222
22200000000222222002200222
22200000000222222002200222
22200000000000022222200222
22200000000000022222200222
22200220022220022220000002
22200220022220022220000002
20000220022220022220022002
20000220022220022224022082
22222220000222222000022002
22222220000222222000022032
22222222222222222222222222
