22222222222222222222222222
20000002222000000002200222
20000002222000000002200222
22222000022222222002200222
22222000022222222002200222
20022002222000000000000222
20022002222000000000000222
22200000022002222002222222
22200000022002222002222222
22200220000222200002222002
22200220000222200072222002
22200222200222200222222002
22200222200222200222222002
22222002200000000000000002
22222002200000000000000002
20022222222002222002222002
20022222222002222002222002
20000000000002222002222002
20000000800062222002222002
20022222200222222000022222
20022222200222222000022222
20022222200000022220022222
20022222200004022220022222
20000002222222200220000002
20050002222222200220000032
22222222222222222222222222
