22222222222222222222222222
20000000000000022222222222
20000000000000022222222222
22222222200222222000000002
22222222200222222000000002
20000000000222222002222222
20000000000222222002222222
22222222200000022002222222
22222222200000022002222222
20000000022220000000000002
25000000022220000000006002
20022220022220022222222222
20022220022220022222222222
22222220022220022220000222
22222220022220022220800222
22200220000000000220022222
22200220000000000220022222
22200000022222200000000002
22200000022222200000000002
20000222200220000002222222
20000222200220000002222222
22222222222220022002222222
22222222222220022002222222
20022000000000022000000002
20022004000070022000000032
22222222222222222222222222
