22222222222222222222222222
20022222222000000222222002
20022222222000000222222002
20022000000002222220022002
20022000000002222225022002
20000002222000022220000002
20000002222080022220600072
22222222222220022222200222
22222222222220022222200222
22222220000000000002200222
22222220000000000002200222
20000222222002222002200222
20000222222002222002200222
20000002222002222002200222
20000002222002222002200222
22222000022222200000000222
22222400022222200000000222
22200000022222200222222222
22200000022222200222222222
22200000000000000002222002
22200000000000000002222002
20000000022002222000000002
20000000022002222000000002
20022222222002200222222002
20022222222002200222222032
22222222222222222222222222
