22222222222222222222222222
20022220022220022002222222
20022220022220022002222222
20000220022220022220000002
20000220022220022220000002
20000000000000000002200222
20000000000000000502200222
22200222200220022222200222
22200222200220022222208222
22200222200222222000000222
22200222200222222000000222
22200222200000000002222222
22200222200000000002222222
22200000022002200222200002
22200000022002200222200002
22222222222002200000000222
22222222222002200000000222
20022002222222200222200222
20022002222222200222200222
20000002200000000222200222
20000002200000000222200222
22200222200222200222222222
22200222207222206222222222
22200000000222200000000002
22200000000222240000000032
22222222222222222222222222
