22222222222222222222222222
20022220022002222222222222
20022220022002222222222222
20022220022220000000000002
20022220022220000000000002
20000220022220022222222002
20000220022220022222222002
20000000000220022222222222
20000000000220022222222222
22222220000000000000000222
22222220000000000000000222
22222220022002222002200002
22222220022002222002250002
20000222222002222002222002
20000222222002222002222002
20000000022002222002222002
20000060022002222002222002
20000220000002222002222002
20000220000002222002222002
22222222222002222222222002
22222222222002222222222002
22200000000000000000022002
22200000008000040000722002
20000222222220000002222002
20000222222220000002222032
22222222222222222222222222
