22222222222222222222222222
20022222222222222000000002
20022222222222222000000002
20000000000000000222200222
20000070000000000222200222
22222002222222200000000222
22222002222222200000000222
20022002222220022222222222
20022002222220022222222222
22200000000002222000022002
22200000000002222000022002
22200222222220022220000002
22200222222220022220000002
22200220022222200222200222
22200220022222200222208222
22200222200002200222200222
22200222200002250222200222
22200220000000000222200222
22200220000000600222200222
22200000000000022220000222
22200000000000022220000222
22200222200220022220000222
22200222240220022220000222
22200222200220000000000002
22200222200220000000000032
22222222222222222222222222
