22222222222222222222222222
20022222222222222222200222
20022222222222222222200222
20000000000000000002200222
20000000000000000002240222
20022220022222222002200222
20022220022222222002200222
22222000000002222002200222
22222000000002222002200222
20022002200000022002200222
20022002200000022002200222
22200002200220022000000002
22200002200220022000000002
22222002222220022222200002
22222002222220022222200002
20022000000220022222222222
20022000000220022222222222
20022002222220022000000222
20022062222220722000000222
20022002222220000000000222
20022002222220000000000222
20000002200000000222200222
20000002250000000222200222
22222222200002222220000002
22222222200002222220800032
22222222222222222222222222
