22222222222222222222222222
20022222200222200220000222
20022222200222200220000222
20000000000222200222200222
20000000000222200222200222
22222220000000000220000002
22222220000000000220000002
22222220022222200000022002
22222220022222200005022002
20000000000222200002222002
20000000000222200002222002
20022222200222200000022002
20022222206222200000022002
22222220000002200222222002
22222220000002207222222002
22200222222222222222222002
22240222222222222222222002
22200002222220022000000002
22200002222220822000000002
22222002200000000002222222
22222002200000000002222222
20000000000000022222222222
20000000000000022222222222
22222222222220000000000002
22222222222220000000000032
22222222222222222222222222
