22222222222222222222222222
20022222222222222000022222
20022222222222222000022222
20000000000000022220000002
20000000000000022220000002
20022222200222222222200222
20022222200222222222240222
20022002200222200000000222
20022002200222200000000222
20022220000222200220022222
20022220800222200220022222
20000220022220022220000002
20000220022220022220000002
22222220000002222222200222
22222220000002222222200222
20000002222000000000000222
20000002222000000000000222
20000222200002200222200222
20006222200002200222200222
22222002222002200222222222
22222002222002200222222222
20000000022002200000000002
25000000022002200000000002
22222220000000022222222002
22222220700000022222222032
22222222222222222222222222
