22222222222222222222222222
20022222200222222222200002
20022222200222222222200002
20000000000220000000022222
20000000000220000000022222
20022222222220022220022002
20022222222220022220022002
20000222200220000220000002
20000222200220000220000502
20022220022220000222222002
20022224022220000222222002
20000000000220022000000222
20000000000220822000000222
22222220000000022222222222
22222220000000022222222222
22200000000222200000000002
22200070000222200000000002
20022222200222200222222222
20022222200222200222222222
22222222200000000002222222
22222222200000000002222222
20000000000220022000000002
20000000000220022000600002
22222222222220022222222002
22222222222220022222222032
22222222222222222222222222
