22222222222222222222222222
20022222222222222002222002
20022222222222222002222002
20000000000000000002200222
20000000000000000002200222
20022220000222222002200222
20022220000222222002206222
20022000022222200000000002
20022000022222200000000502
20022002222002200222222222
20022002222002200222222222
20022000000002222222222222
20022000000002222222222222
22222220000000000000000002
22222220700000000000000002
22200000022220022222222222
22200000022220022222222222
22222002222000022002200222
22222002222000022082200222
20022002222220022000000222
20022002222220022000000222
20000000000000000002200222
20000000000000000002200222
22222222222222222002200002
22222222222222222402200032
22222222222222222222222222
