22222222222222222222222222
20022222222220022220022002
20022222222220022220022002
20022000000220000000022002
20022000000220008000022072
20000000000220022220022002
20000000000220022220022002
22200222222220022000022222
22200222222220022000022222
22200002222220022220000002
22200002222220022225000002
22200222200000022222222002
22200222200000022222222002
20000000000220000002222002
20000000000220000002222002
22222002200222222002222222
22222002200222222002222222
22200002222220000000000222
22200002222220000000000222
22200222222220022222200002
22200222222220022222200002
22200000000222222002222002
22200000000222222402222002
22200222200000000002222002
22200222200000006002222032
22222222222222222222222222
