22222222222222222222222222
20000002222222200222200222
20000002222222200222200222
22222002200000000222200222
22222002200000007222200222
22200000000222222222200222
22200000000222222222200222
22200222200000000000000222
22200222200000000000006222
22200220000220000222222002
22200220000220040222222002
20022220022220000002222002
20022220022220000082222002
22200000022222200222200222
22200000022222200222200222
22200220022000000222200222
22200220022000000222250222
22200220022002222220000002
22200220022002222220000002
20000220022002222222222002
20000220022002222222222002
20000220000000000000000002
20000220000000000000000002
22222220022222222222222002
22222220022222222222222032
22222222222222222222222222
