22222222222222222222222222
20022222222222200000000002
20022222222222200500000002
20000000000002222002222002
20000000000002222002222002
22222222222002200002222002
22222222222002200002222002
22200000000000000220022002
22200000000000000220622002
22200220022222200222200002
22200220022222200222200002
20022220022222222222222222
20022220022222222222222222
20022220000000022000000222
20022220000000022004000222
22200000022220022222200222
22200000022220022222200222
22222002222000000222200222
22222002222000000222200222
20000000022222200220000222
20000000722222200220000222
20022220022002200000022222
20022220022002200000822222
22222000022000022220000002
22222000022000022220000032
22222222222222222222222222
