22222222222222222222222222
20000002222222200002222222
20000002222222200002222222
20022222200000000222200002
20022222200000000222200402
20022000000002222002200222
20022000000002222002207222
20000002200220022222200222
20000002200220022222200222
22222222200222200000000222
22222222206222200000000222
22222222200222200222200222
22222222200222200222200222
20000000000002200222222222
25000000000002200222222222
20022002222222200000022002
20022082222222200000022002
20022002222002222002222002
20022002222002222002222002
20022002222002222002222002
20022002222002222002222002
22222002200000000000022002
22222002200000000000022002
20022000000002222220000002
20022000000002222220000032
22222222222222222222222222
