22222222222222222222222222
20000222200000022222222222
20000222200000022222222222
20022222200220000000000002
20022222200220000000600502
20000000000220022000022002
20000000000220022000022002
22222222222220022002222002
22222222222220022002222002
22222222222000022222222002
22222222222000022222222002
20000000022000022220022222
20000000022000022220022222
20000220000002222220022222
20000220000002222220022222
22222222222000000000000002
22222222222000000000000002
22200000000000022222222002
22200000008000022222222002
22200222222222200220000002
22200222222222200220000002
22200002222222222222222002
22200002222222222222222002
22200222200000000000000002
22200222200004000070000032
22222222222222222222222222
