22222222222222222222222222
20022222222000000002222222
20022222222000000002222222
20000000000002222000000002
20000000000002222000000002
20022222200222200000022222
20022222200222200000022222
22222000000002222220000222
22222000000002222220000222
22200000022002222000022002
22208000022002222000022002
20000222222000022220022002
20000222222000022220022002
20022220022220022220000002
20022220722220022220000002
20022220022220022220022222
20022220022220022220022222
20022220022220022222222222
20022220622220022222222222
20022220022220000000000002
20022220022220000000000002
20022220022220022002222002
20022220022220022002222002
20022220000000022002222002
25022220000000022402222032
22222222222222222222222222
