22222222222222222222222222
20000222200222200000022002
20000222200222200000022002
22200222200222200222222222
22200222200222200222222222
22200000000002200000000002
22200000000002200000000002
20000220022000000222200002
20000220022000000222206002
22222220022222200002222002
22222220022222200002222002
22200000000002200222222002
22208500000002200222222002
20022220022002200000022222
20022220022002200000022222
20000220022222200222222002
20000220022222200222222402
20000220022002200222222002
20000220022002200222222002
22222222222222200220022002
22222222222222200220022072
20000000000000000000000002
20000000000000000000000002
22222222222222222222222002
22222222222222222222222032
22222222222222222222222222
