22222222222222222222222222
20000222222222200220000002
20000222222222200220000002
22200220000000022222222002
22200220000000022222222402
22200220000222222002222002
22200220000222222002222002
22200220022220022002222002
22200220722220022002222002
22200000022220022002200002
22200000022220022082200002
22222000022000000002200222
22222000022000000002200222
20000000000002200000000222
20000000000002200000000222
22222222222002222222200002
22222222222002222222200002
22222002222000022222222222
22222502222000022222222222
20000000000000022000000222
20000000000000622000000222
22200222200220000002200222
22200222200220000002200222
22200222200222222222200002
22200222200222222222200032
22222222222222222222222222
