22222222222222222222222222
20000222222220022002222222
20000222222220022002222222
20022220000000022220000002
20022220000000022220000002
20000000000220022222200222
20000000000220022222200222
22222222222220000000000222
22222222222220000000000222
22200000022220022222200222
22200000022220022222200222
20022220000222222222200222
20022220000222222222200222
20022220000220000000000222
20022224000220000000000222
22200000000222222220000222
22206000000222222220000222
22200220022222200000022222
22200220022222200000022222
22200220000002200220000002
22200220000002200220750002
20000222222000000222222002
20000222222000000222222002
22222000022002222000022002
22222000022082222000022032
22222222222222222222222222
