22222222222222222222222222
20000222222000000222200222
20000222222000000222200222
22200220000002222002200222
22200220000002222002200222
22200002222002200220000002
22200002222002200220000002
22222000000002222220022222
22222000000002222220722222
20000002222222200000000222
20006002222222200000000222
20000002222220000222200222
20000002222220000222200222
20000222200220022222222222
20000222200220022222222222
20000000000000000000000002
20000000000080000000040002
20022220022002222002222222
20022220022002222002222222
20022220022222222002222222
20022220022222222002222222
20022220022220000000000002
20022220022220000000000002
22222000022002222222222002
22222005022002222222222032
22222222222222222222222222
