22222222222222222222222222
20022222222220000000000222
20022222222220000000000222
20000000000222222222200222
20000000000222222222240222
20022222200220022000000222
20022222200220022000000222
20022222200222222222200222
20022222200222222222200222
20000000022220000000000222
20000000022220000000008222
20022000022220022222200222
20022000022220022222200222
20022000000000000222200222
20022000000000000222200222
20022000000222200222200222
20022000000222200222200222
20000222200000022222200222
20000222200000022222200222
22200002222222222002200222
22250002222222222062200222
22200222200222200000000222
22200222200222200000000222
22200000000220022222200002
22200070000220022222200032
22222222222222222222222222
