22222222222222222222222222
20022222222000022222222222
20022222222000022222222222
20000000000222200000000002
20000004000222200000000002
22200222222000000000022222
22200222222000000000022222
22200220000002222220000222
22200220600002222220000222
22200220022002200000000222
22200220022002200000008222
22200220022222222222200222
22200220022222222222200222
22200220000220000222200222
22200220000220000222200222
20000000000000000222200222
20000000000000000222200222
22222002222220000222200222
22222072222220000222200222
22222002200220022220000222
22222002200220022220000222
20000000022220000222200222
20000000022220050222200222
20022222200002222220000002
20022222200002222220000032
22222222222222222222222222
