22222222222222222222222222
20000000000002200222200222
20000000000002200222200222
22200220022222222002200222
22200220022222222002200222
22200222222220000002200222
22200222222220000002200222
20000222200222200222200222
20000222200222200222200222
20022222200000000222200222
20022222200000600222207222
20022002200222200000000222
20022002200222200000000222
20000000000000022222200222
20000500000000022222200222
20000000022220022222200222
20000000022220022222200222
22200220000220022000000002
22200220000220022000000002
22200222200222222002222222
22200222200222222002222222
20000220000222222002222222
20000220008222222402222222
22222002222220000000000002
22222002222220000000000032
22222222222222222222222222
