22222222222222222222222222
20000222200000000002222222
20000222200000000002222222
22200000000222200222200002
22200000000222200222200002
22200222222002200222200222
22200222222002200222200222
22200000022222200222200222
22200000022222200222240222
22200002222002200222200002
22200002222002200222200002
20022002222002200002222002
20022502222062208002222002
22222002222000000222222002
22222002222000000222222002
20000002222220022220000002
20000002222220022220000002
22222002200000000000000002
22222002200000000000700002
22200002200002222222222002
22200002200002222222222002
22200222200000000002222002
22200222200000000002222002
22200222200222222222200002
22200222200222222222200032
22222222222222222222222222
