22222222222222222222222222
20000000022222222222200222
20000000022222222222200222
20022220000000000000000222
20022220000000000060000222
20022220000222222222222222
20022220000222222222222222
22200220000000022220000002
22200220000000822220000002
22222222222220022000022222
22222222222220022000022222
20000000000000022002200222
20050000000000022002200222
22222002222220000002200222
22222002222220000402200222
22200000022222222000000222
22200000022222222000000222
22200000022002222220000222
22200000022002222220007222
22200220022000000000000222
22200220022000000000000222
22200220022002200222200222
22200220022002200222200222
22200222222002200222200002
22200222222002200222200032
22222222222222222222222222
