22222222222222222222222222
20022220022002222002200222
20022220022002222002200222
20000002222002200222200222
20000002222072200222200222
20022222222002200222200002
20022222222002200222200402
20022220022002200222200222
20022220022082200222206222
20022220000000000000000222
20022220000000000000000222
20022220022000022222200222
20022220022000022222200222
20022002222000000222200222
20022002222000000222200222
20022220000002200002200222
20022220000002200002200222
20022220000222200222200222
20022220000222200222200222
20022222200222200002200002
20022222200222200002200002
20000000000222200002222002
20000000000222200502222002
22222220000002222220022002
22222220000002222220022032
22222222222222222222222222
