22222222222222222222222222
20000002222000022222200222
20000002222000022222240222
20022220022220000002200222
20022220022220000002200222
20022222200222200222200222
20022222200222200222200222
20000000000000000000000222
20000000000000000070000222
22200222222222222222200222
22200222222222222222200222
22200220022222222002200222
22200220022222222002206222
22200220022000000222200222
22200220022500000222200222
22200000022220022222200002
22200000022220022222200002
22200000000220000002222222
22200000000220000002222222
22200002200222200222200222
22200002200222200222200222
22200002200000000000000222
22200002208000000000000222
20022220000222200222200002
20022220000222200222200032
22222222222222222222222222
