22222222222222222222222222
20022220000222200000022002
20022225000222200000022002
20000000022222200222222222
20000000022222207222222222
22222002222000000222200002
22222002222004000222200002
20000002222222200222200002
20000002222222200222200002
20022222200222200000000222
20022222200222200000000222
20022222200002222000000222
20022222200002222000000222
20022002200222222220022222
20022002200222222220022222
20000000000000000000000002
20000000006000000000000002
20022222222002222222200222
20022222222002222222200222
20022000022222222222200222
20022000022222222222200222
20000000000220000000000002
20000080000220000000000002
22222222200222222222222002
22222222200222222222222032
22222222222222222222222222
