22222222222222222222222222
20022220022222200000000222
20022220022222200000000222
20000002200000000222222222
20000002200000000222222222
22222002222222200222200002
22222002222222200222200502
22200000000000000002200222
22200080000000000002200222
22200222200220000000000222
22200222207220000000000222
22200222222220022000022222
22200222222220022060022222
22200220022220022220000002
22200220022220022220000002
20022220022000022220000222
20022220022000022220000222
22200000000220022222200222
22200000000220022222200222
22200222200222222000000002
22200222200222222000000002
22200222200000000000022002
22200222200000000000022002
22200002222222222222222002
22240002222222222222222032
22222222222222222222222222
