22222222222222222222222222
20022220022222222222200222
20022220022222222222200222
20000000022000000000000222
20000000022000000000000222
22222002222222200222200222
22222002222222200222200222
22200002200000000222200222
22200002200060008222200222
22222000000222222220000222
22222070000222222220000222
20022222222220000000000222
20022222222220000000000222
20000220022220022002222002
20000220022220022002222002
22200222200000022222222222
22200222200000022222222222
22200222200222222220000002
22200222200222222220000002
22200220000000000000022002
22200220000500000000022002
22200000000002222000022002
22200000000002222000022002
20022222222000000222222002
20022222222000040222222032
22222222222222222222222222
