22222222222222222222222222
20022000000000000222222002
20022000000000000222222002
20022002222220022220000222
20022002222220022220000222
20000000000222222000000222
20000000000222222000000222
20022222222220022002200222
20022222222220822002200222
20000002222002222002222222
20000002222002222002222222
22222002222000000002222002
22222002222000000002222502
22200000000000022222222002
22200000000000022222222002
22200222200222222000000002
22200222200222222000000002
22200222200222200002222002
22200222200222200002222002
22200222200222200222222222
22200222200222200222222222
22200222200220000000000222
22207222200220000000600222
22200222200000022222200002
22200222200400022222200032
22222222222222222222222222
