22222222222222222222222222
20022222222000000222222222
20022222222000000222222222
20000000022002222220000002
20000000022002222220000002
20022002222000000000022222
20022082222000000005022222
20022002222002200222200222
20022002222002200222207222
20022002222002200002200222
20022002222002200002200222
20022000000002222002200222
20022000000002222002200222
20022222222002222000000002
20022222222002222000000002
22222222222002222002222222
22222222222002222002222222
22200000022222222000000002
22200000022222222000000002
22200000000000000002222002
22200060000004000002222002
20000222222222222002222002
20000222222222222002222002
22222000000220000002222002
22222000000220000002222032
22222222222222222222222222
