22222222222222222222222222
20022222200222222222200002
20022222200222222222200002
20000000000220000000000002
20000000000220000000000002
22200222200220000222222002
22200222200220000222222002
22200222200220022222222002
22200222200220022222222502
22200222200000000000022222
22200222200080000070022222
22200222222220022002222222
22200222222220022002222222
22200220000000022002200002
22200220000000022002200002
22200000022220022000000222
22200000022220022000000222
22200222200002200222200222
22200222200002200222200222
22200220022222222000000002
22200220022222222000000002
22200222200000000000022002
22200222200000000060022002
22200222200222200222222002
22240222200222200222222032
22222222222222222222222222
