22222222222222222222222222
20022222222222222000000002
20022222222222222000000002
20000000000000000002222222
20000000008000000002222222
20022222222222222222200002
20022222222222222222200002
20022220022222222220022222
20022220022222222220622222
20022000022000000000000002
24022000022000000000000002
20000002222002222002222222
20000002222002222002222222
22222002200000022002222222
22222002200000022002222222
22222000000220022000000002
22222000000220022000000002
20000000022220022000022222
20000000022220022000022222
22222000022222222220000222
22222000022222222220000222
22200000000000000220000222
22207000000000000220050222
20022222222222222220000002
20022222222222222220000032
22222222222222222222222222
