22222222222222222222222222
20022220000222200002200222
20022220000222200002200222
20000222200222222002200222
20000222200222222002200222
22200220000000000000000222
22208220000000000000000222
22200222200220000222200222
22200222200220000222240222
22200222200222200222200222
22200222200222200222200222
22200220000222200000000222
22200220000222200000000222
22200220000002222222200222
22200220000002222222200222
20000000000002222222200222
20000000000002222222200222
20022220022222200000000222
20022220022222200000000222
22200000022222222000000222
22200060022222222000700222
22200222222000000002222222
22200222222000000002222222
22200220022002222000000002
22200220022502222000000032
22222222222222222222222222
