22222222222222222222222222
20000002222222222222222002
20000002222222222222222002
22222000000000000000000222
22222000000005000000000222
22200222200222222222222222
22200222200222222222222222
22200222200222222222222002
22200222200222222222222002
22200220000000000000022002
22200220000000000000022002
20000000022222200000000002
20000080022222207000000002
22222002222000000220022222
22222002222060000220022222
20022222222002222222222222
20022222222002222222222222
20022220022002222000000002
24022220022002222000000002
20022220000000000002222222
20022220000000000002222222
20000000022220022000000002
20000000022220022000000002
20000000022220022222222002
20000000022220022222222032
22222222222222222222222222
