22222222222222222222222222
20000000000222222000000002
20000000000222222000050002
22222222200000022002222002
22222222200000022002222002
20022222222002222002222002
20022222222002222002222002
22200000022002200002222002
22200080022002200002222002
22200220000000000222222222
22200220000000000222222222
22200222222220000000000222
22200222222220000000000222
22200222222000022002200222
22200222222000022002200222
22200000022002222002222002
22200000022002222002222002
20000222222002222002200222
20000222222002222002200222
22222002200002222000000222
22222062200002222000000222
22222220000222222002222222
22222220000222222002222222
20000000022220000000000002
20000000022220740000000032
22222222222222222222222222
