22222222222222222222222222
20000000000000000000000222
20000000000000000000000222
20022220022000022222200222
20022220022000022222200222
20022220022220000222200222
20022220022220800222200222
22222220000222222222200002
22222220700222222222200502
22200222200002222002222002
22200222200002222002222002
22200222222002200002200222
22200222222002200002200222
22200000000000000222222222
22200000000000000222222222
22200222200220000000000002
22200222200220000000000002
22200222200220022220022002
22200222200220622220022002
22200002222220022222222002
22200002222220022222222002
22222002222000000002222002
22222002222000000002222002
20000002200002222002222002
20040002200002222002222032
22222222222222222222222222
