22222222222222222222222222
20000222200000000222222222
20000222200005000222222222
22200222200002222220000002
22200222200002222220000002
22200002222002222220022222
22200002222002222220022222
20000002222002200000000222
20000002222002200070000222
20022000022000000222222222
20022000022000000222222222
20022220022222200222200002
20022220022222200222200002
20000222222002200000000222
20000222222002200000000222
20022222200222222002200222
20022222200222222082200222
20000000000000022002200222
20000000006000022002200222
22222222200220000002200002
22222222200220000002200002
20000000000220022002222002
24000000000220022002222002
22222222222220022002222002
22222222222220022002222032
22222222222222222222222222
