22222222222222222222222222
20000000000222222222222002
20000000000222222222222002
22200222200220000000022002
22200222200220600000022002
22200002222220022220022002
22200002222220022220022002
20022000022220022220000002
20022000022220022220000002
22222220000220000002222222
22222220007220000002222222
20000000000000022000022002
20000000000000022004022002
20022002222220022220000222
20022002222220022220000222
22222222222220022222200222
22222222222220022222200222
22200220000000000002200222
22208220000000000002200222
22200000022002222222200222
22200000022002222222200222
22200222222000000222200222
22200222222000000222250222
20022220000002222220000002
20022220000002222220000032
22222222222222222222222222
