22222222222222222222222222
20022222222220000000000002
20022222222225000000000002
20000000000000000002222002
20000000000070000002222002
22222002222222200002222222
22222002222222200002222222
22200002222220022002200222
22200002222220022002200222
22222222200002222002200222
22222222200002222002200222
20000222200222200000000002
20000222208222200000000002
22200000000222222000022222
22200000000222222060022222
22200222200000000000000222
22200222200000000000000222
22200222200220022222200222
22200222200220022222200222
20000222222222222222200222
20000222222222222222200222
20022000000000000000000002
24022000000000000000000002
20022222200222222222222002
20022222200222222222222032
22222222222222222222222222
