22222222222222222222222222
20000002222222222220022002
20000502222222222220022002
22200222200000000000022002
22200222200000800000022002
22200220000222222222222222
22200220000222222222222222
22200220000000000000000002
22200220600000000000000002
22200220022222222220000002
22200220022222222220000002
22200220022220022002222002
22200220022220022002222002
22200000000000000222200002
22200000000000000222200072
22200222222222200222200222
22200222222222200222240222
22200222222220000222200222
22200222222220000222200222
20000220000222200222222222
20000220000222200222222222
20022220000222200000000002
20022220000222200000000002
22222000000000000222222002
22222000000000000222222032
22222222222222222222222222
