22222222222222222222222222
20000222200222222222222222
20000222200222222222222222
22200222200220000000000002
22200222200220000000000002
22200222200000022222222222
22200222200060022222222222
22200000000220022220022002
22200000000220022220022002
20022000022220000000022002
20022000022220007000022002
20022220022222200220000222
20022220022222200225000222
22200220022000000222200222
22200220022000000222200222
22200000022222222220000222
22200000022222222220000222
20000002222222200222222222
20008002222222200222222222
20022002200000000220022002
24022002200000000220022002
20022000000222222222222002
20022000000222222222222002
20022222200000000000000002
20022222200000000000000032
22222222222222222222222222
