22222222222222222222222222
20000000000002200222222222
20000000050002200222222222
22200220000222222000000002
22200220000222222000000002
22200222222220000002222222
22200222222220000002222222
22200000000000000222200222
22200000000000000222200222
22200222222002222222200222
22200222222002222222200222
22200002222000022000000222
22200002222000022000000222
22200002222002222222200222
22200082222002222222207222
22222000022000000000000222
22222000022000000000000222
20000000022222222002200222
20000000022222222062200222
20022000000222222002200222
20022000000222222002200222
20022222200000022002200222
20022222200400022002200222
22222000000222200222200002
22222000000222200222200032
22222222222222222222222222
