22222222222222222222222222
20022220022222200000000002
20022225022222200000040002
20000000000000000222222222
20000000000000000222222222
22200222222220022222222222
22200222222220822222222222
22200222200000000000000002
22200222200000000000000002
22200002222222222222222222
22207002222222222222222222
20022000022000022002200222
20022000022000622002200222
22222220000222200222200002
22222220000222200222200002
20000000000222200222222002
20000000000222200222222002
20022222200222200000000002
20022222200222200000000002
20022220000000000222200222
20022220000000000222200222
20022220022002200222200222
20022220022002200222200222
20022002222002200222200002
20022002222002200222200032
22222222222222222222222222
