22222222222222222222222222
20000222200000022222222222
20000222200000022222222222
20022222222220022000000002
20022222222220022004000002
20000000022220022220022002
20000000022220022220022002
22200220022220000220022002
22200220022220000220022002
22200220022222200000022222
22200220022222200000022222
20022220022000000222200002
20022220022000000222200002
22200000000000000220022222
22200000000000000220022222
22222222222220000000000002
22222222222220800000000062
20000002200220022222222222
20000002200220022222222222
22222002222220000002222222
22222002222220000002222222
22200000000000022000000002
22200000000005022000000072
20022222222220022222222002
20022222222220022222222032
22222222222222222222222222
