22222222222222222222222222
20000000000000000000022222
20000000000000000000022222
22200222222222200220022002
22200222222222200220022502
22200222222222200220000002
22200222222222200220000002
20000220000000000222200222
20000220006000000222200222
22222220022222200222200222
22222220022222200222200222
22222000022220000220000222
22222000722220000220000222
20000002222220022220000222
20000002222220022220000222
20000222200000000222200222
20000222200000000222200222
22200222200222222220000222
22200222200222222220800222
22200220000220000222200002
22200220000220000222200002
22200222200222222002222002
22200222200222222002222002
22200222200000000002222002
22200222200000000402222032
22222222222222222222222222
