22222222222222222222222222
20000222222222222002222002
20000222222222222002222002
22200000000000000002200222
22200000000000000002200222
22200222200222222002200222
22200222200222222002200222
20000222200222222222200222
20000222200222222222200222
20000222200220000222200222
20000222200220000222200222
22222222200220022220000222
22222222200220022220000222
22200002200220022222200222
22200002200220022222200222
20022000000000022000000222
20022000000000022004000222
20022002222000000002222222
20022002222000000002222222
22222222222220000002222002
22222222222220000082222002
20000000000000000000022002
20000005000060000000022072
22222220000222222000000002
22222220000222222000000032
22222222222222222222222222
