22222222222222222222222222
20000000022222200002222002
20000000022222200002222002
22222220000002200002222002
22222220006002240002222002
22200000022220000222222002
22200000022220000222222002
22222220022000022220000002
22222220022000022220000002
20000000000002222002200222
20000000000002222002207222
20022222222002222002200222
20022222222002222002200222
20000222222222222000000222
20008222222222222000000222
20022220000000022222200222
20022220000000022222200222
20022222200220000222200222
20022222200220000222200222
20000000000222200222200222
20000000000222200222200222
20022002222000000000000002
20022002222000050000000002
22222000022222222222222002
22222000022222222222222032
22222222222222222222222222
