22222222222222222222222222
20022220000002222000022222
20022220000002222000022222
20022220000222200220000002
20022220000222200220000002
20000000022220022220022222
20000000022220022220022222
20022222222220000220000222
20022222222220000220800222
20000002200000000222200222
20000002200000000222200222
22222000000222200222200222
22222000700222200222200222
22200002200002200222200222
22200062240002200222200222
22200002222222200222200222
22200002222222200222200222
22200002222222200000000222
22200002222222200000000222
22200000000002222222200222
22200000000002222222200222
22200222222220000000000002
22200222222225000000000002
22200000022220000222222002
22200000022220000222222032
22222222222222222222222222
