22222222222222222222222222
20022220022222200220000002
20022220022222200220000002
20022220000000000220000002
20022220000500000220000002
20022220022222222222222002
20022220022222222222222082
20022220022222200000000222
20022220022222200000000222
20000000022000000222200222
20000000022000000222200222
22200222222002200002222002
22200222222002200002222002
22200222222002222222200222
22200222222002222222240222
22200000022002222220000222
22200000022002222220006222
22200220000002200000022002
22200220000002200000022002
22200222222000000220022002
22200222222000000220022002
22200000000222222220022222
22200000700222222220022222
20022222200220000220000002
20022222200220000220000032
22222222222222222222222222
