22222222222222222222222222
20000000000002222000000222
20000000000002222000000222
20022220022220022220000222
20022220022220022220000222
20022220022222200000000002
20022220022222200000000002
20022220000002200222200222
20022220000002200222200222
22222220022002200222200222
22222220022002206222200222
22200222222000000222200222
22200222222000000222208222
22200222222002222000000222
22200222222002222000000222
20000000000002222002200222
20000000000502222002200222
20022222200000022002200002
20022222200000022002200002
20022220000222222002222222
20022220000222222002222222
20000222200222222002222222
20000222207222222002222222
22222002200220000000000002
22222002200220040000000032
22222222222222222222222222
