22222222222222222222222222
20022222200002222222200222
20022222200002222222200222
20000000000222200000000222
20000000000222206000000222
20022222200222200220000222
20022222200222200220000222
20000222200002222222200222
20050222200002222222200222
22222222222002222002200002
22222222222002222002200002
22222000000000000000000002
22222000000000000000000002
20022222222002222002222222
20022222222002222002222222
20022222222002222000000222
20022222222002222000008222
20000000000002200222200222
20007000000002200222200222
20022222222002222222200222
20022222222002222222200222
20022220000002200002200002
20022220000002200002200002
22222000022220000000000002
22222400022220000000000032
22222222222222222222222222
