22222222222222222222222222
20022222200220022222200002
20022222200220022222200002
20000000022220022000022222
20000000822220022000022222
22222220000000022220000002
22222220000060022220000002
22222222222220022000022222
22222222222220022000022222
20000000022220022000000002
20000000022220022000000002
22200222200220000002222222
22200222200220000002222222
22200222222222200222200222
22200222222222200222200222
22200000000002200222200222
22200000000002200222200222
20000222222002200222200222
20000222222002200222200222
20022000000000000000000002
20022000000000000000000002
22222002222002200222222002
22222002222002240222222002
20022002200222200002222002
20022502207222200002222032
22222222222222222222222222
