22222222222222222222222222
20000000000000022222200222
20000000000000022222200222
22200222222220000002200222
22200222222220000072200222
22200000000222222222200222
22200000000222222222200222
22200220000000000000000222
22200220000000000080000222
22222222200222222000000222
22222222200222222000000222
20000000000222222222200222
25000000000222222222200222
20022222222220000222200222
20022222222220000222200222
20000222200000022222200222
20000222200000022222200222
20022220000000000002200222
20022220000000000002200222
20000222222222200222200222
20000222222222200222200222
22222222200000000000000222
22222222240000000000600222
20022000000222222222200002
20022000000222222222200032
22222222222222222222222222
