22222222222222222222222222
20000000022220022222222002
20000000022220022222222002
22222002222220000000000222
22222002222220000000000222
22222000000222222220000222
22222000000222222220000222
20000002222220022220022222
20000002222220022220022222
22222000000220022220022002
22222000000220822220022002
22200002200220000000000002
22200002200220000000000402
22222002200000000220022222
22222002200000000220022222
20000002222002200220000002
20000002222002206220000002
20022220022002222220022222
20022220022002222220022222
20022222222222222000022222
20022222222222222000022222
20000000000220022000000002
20000000000220022000000072
22222222200000022222222002
22222222200005022222222032
22222222222222222222222222
