22222222222222222222222222
20022220022220022002222002
20022220022220022002222002
20022220022002222002222002
20022220022002222002222062
20000000000002222002222002
20000000000002222002222002
22222002200002222002222002
22222002200002222002222002
22200002222000022002222002
22250002222000022002222002
22222222222000000002200002
22222222222000000002200002
20000220000002222002200002
20000220007002222002200002
22200000022220022000000222
22200000022220822000000222
22222222222222222002222222
22222222222222222002222222
20022000000000000000000002
20022000000000000000000002
20000002200222200222222002
20000402200222200222222002
22222222200222200002222002
22222222200222200002222032
22222222222222222222222222
