22222222222222222222222222
20000002222002200222200222
20000002222002200222200222
20022000000002222002200222
20022000000002222002200222
20022222200002222002200222
20022222200002222002200222
22222220000000000000000222
22222220000000000000000222
22200222222000022220022222
22200222222080022220022222
22200002222000022220000002
22200502222000022220000002
22200000022220022220022002
22200000022220022220022002
20000220022220000220022222
20000220022220000220022222
22222220000222200222200222
22222224000222200222200222
22200000022222200000000222
22207000022222200000000222
22200220000000000222200222
22200220000000006222200222
22200222222220000222200002
22200222222220000222200032
22222222222222222222222222
