22222222222222222222222222
20000220022220000000000222
20000220022220000400000222
22200222200222222222200222
22200222200222222222200222
22200220000222222222200222
22200220000222222222200222
20000002200000000000000002
20000002206000000000000002
20022002200222222220022222
20022002200222222220022222
22222002200222200002200002
22222002200222200002200002
22200000000220022002222002
22200000000220022002222002
22200222200000022220000222
22200222200000022220000222
22200222222220022222200222
22200222222220022222200222
22200000000220000000000002
22200000000220000000007002
22200222200220000222222002
22250222200220000222222002
22200222200222222220000002
22200222208222222220000032
22222222222222222222222222
