22222222222222222222222222
20000222200002222222222002
20000222200002222222222002
22200002222002200000022002
22200002222002200000822002
22200222222002200220000002
22200222222002200220000002
22200000000000000222222222
22200000000000000222222222
20000222200222200000000222
20007222200222200000040222
20022222200222200220000002
20022222200222200220000002
22222002222222200222222002
22222002222222200222222002
20022000000000000220022002
20022000000000000220022002
20022222200222200222222002
20022222200222206222222002
22200222200222200220000002
22200222200222200220000002
22200222200222200220022002
22200222200222200220022002
22200000000220000222222002
22200000000225000222222032
22222222222222222222222222
