22222222222222222222222222
20022220000000000000000002
20022220000000000000000002
20000000022220022222222222
20000000022220022222222222
22222002222000022222222222
22222502222004022222222222
20000002222002222000000002
20000002222002222000000002
20022220000000000002222222
20022220000000000002222222
22222220022222200000022222
22222220022222200000022222
22200220000002222222222002
22200220006002222222222002
22200222200222222222222002
22200222200222222222222002
22200222200000000000000002
22200222200000700000800002
22200220022220022222222002
22200220022220022222222002
20000002222220022220022002
20000002222220022220022002
22222000000000000002222002
22222000000000000002222032
22222222222222222222222222
