22222222222222222222222222
20000000000222222220000002
20000000000222222220050002
22200222222220000000022222
22200222222220000000022222
22200222222220022222222222
22200222222220022222222222
22200000000000022002200002
22200000000000022002200002
22200222200000022222200222
22200222200000022222206222
22200220000000000000000222
22200220000000000000000222
22200222200222222000000222
22200222200222222000007222
22200222200000022222200002
22200222200000022222240002
22200222200220022220022222
22200222200220022220022222
20000222200222222002222222
20000222200222222002222222
20022222200222200000000002
20022222200222200000008002
22222000000000000002222002
22222000000000000002222032
22222222222222222222222222
