22222222222222222222222222
20000000022222222222200222
20000000022222222222200222
22222002222000000000000222
22222002222000000060000222
22200000022002222222222222
22200000022072222222222222
20000220000000000000000002
20000220000000000000000002
20022222200222222222222222
20022222200222222222222222
20022000000222222220022002
25022000000222222220022002
22222222200220000002200222
22222222208220000002240222
22200222200000022222200222
22200222200000022222200222
20000000000220000000000002
20000000000220000000000002
22200222200222200222222002
22200222200222200222222002
22200220000002200002222002
22200220000002200002222002
22200220022220022222200002
22200220022220022222200032
22222222222222222222222222
