22222222222222222222222222
20022220000002222222200222
20022220000002222222200222
20000000022002200000000222
20000000022002200000000222
20022002222000000002222222
20022002222000000082222222
20022002222002222000000002
20022002222002222000000002
22222002222002200222222002
22222002222002200222222002
22200002222222222222200002
22200002222222222222200502
22200222200000000002222222
22200222200000000002222222
22200002200222222002200222
22200002200222222002200222
20000000000222200000000222
20000000000222200000000222
22222220022222222220000222
22222220022222222220000222
22222220000000022220000002
22222220040070022220000062
20000000022220022002222002
20000000022220022002222032
22222222222222222222222222
