22222222222222222222222222
20022222200222200222200222
20022222200222200222200222
20022002200222200222200222
20022002200222200222200222
20000000000222200220000222
20000000000222200220006222
20022002222222200000000002
20022502222222200000000002
22222000022000000220022002
22222000022000000220022002
22222220000000022220022222
22222220000000022220022222
20000000000000022220000222
20000000000000022220040222
22200220022220022222200222
22200220022220022222200222
22200220022220000002222222
22200220022220000072222222
22200220022222200002222002
22200220022222200002222002
22200220000002200222222002
22200220000002208222222002
20022220022222200000000002
20022220022222200000000032
22222222222222222222222222
