22222222222222222222222222
20000000000000022222222222
20000000000000022222222222
20022222200002222000000002
20022222200002222000000402
22222002222000000002222222
22222002222000000002222222
22200000000002200222222002
22207000000002200222222002
22200002200222200220022002
22200002200222200220022002
22200222200222200000000002
22200222200222200000000002
20000222200222222222222222
25000222200222222222222222
20022220000000000000000222
20022220000000000060000222
20022220022220022222200222
20022220022220822222200222
22222000000220022222200222
22222000000220022222200222
22200002200220022000000222
22200002200220022000000222
22200002222220022222200002
22200002222220022222200032
22222222222222222222222222
