22222222222222222222222222
20022220000222200002222002
20022220000222200402222002
20000000000222200002200222
20000000000222200002200222
20022222200002200222200222
20022222200002200222200222
22200222222000000222200002
22200222222000000222200002
22222000000002200222200002
22222000000002200222200002
20022000022222200002200222
25022080022222200002200222
20022000022222200222200222
20022000022222200222200222
20000000000002200000000222
20000000000002206000000222
22222002222222222222200222
22222002222222222222200222
22200000000220022222200222
22200000000220022222200222
22200222200000000002200222
22200222200000007002200222
22200220022222222222200002
22200220022222222222200032
22222222222222222222222222
