22222222222222222222222222
20022002222220000222222222
20022002222220000222222222
20022002200222200000000002
20022072200222200000006002
20000000000002200220022222
20000000000002200220022222
22200222222222200220000222
22200222222222200220000222
22200222222220000220022002
22200222222220000220022002
22200220000000022220022222
22200220000000022220022222
22200220000002222220022002
22200220000002222220022002
22200000022222200000000002
22200000022222200000000002
22200222222000000002222222
22200222222000000002222222
20022002222002222222200222
20022502222002222222200222
20022000000000000000000002
20022000000000000004000082
20022002222222222222222002
20022002222222222222222032
22222222222222222222222222
