22222222222222222222222222
20022220000220000002222222
20022220000220000002222222
20000220000222222220000002
20000225000222222220000002
22200222200000000000022222
22200222200000000000022222
22200002200220000002200222
22200002200220700002200222
22222000000222222222200222
22222000000222222222200222
20000002200222222222200222
20000002200222222222200222
22222222200000000002200222
22222222200000000002200222
22222222200000022000000222
22222222200000022000000222
20000000000000022222200222
20000000000000022222200222
20022222200220000222222222
20022222200220800222222222
20000222200222200000000002
20040222206222200000000002
22222220000220022222222002
22222220000220022222222032
22222222222222222222222222
