22222222222222222222222222
20022222222002222222200002
20022222222002222222200002
20000000000000000000022222
20000000000070000000022222
22222222200002200220022002
22222222200002200220022002
22200000000002200222222002
22200000000002200222222502
22200222222002222222222002
22200222222002222222222002
22200222200000022000000002
22208222200000022000000002
22200222200222222220000222
22200222206222222220000222
22200222200222200000000222
22200222200222200000000222
22222222200220000002222002
22222222200220000002222002
20000002200222222000022002
20000002200222222000022002
20022000000000000000000002
20022000000000000000000002
20022222222222222222222002
24022222222222222222222032
22222222222222222222222222
