22222222222222222222222222
20022220022222222222222002
20022220022222222222222002
20000000000000000000000222
20000000000000000000000222
22200222200222222222222222
22200222200222222222222222
22200002200222200220022002
22200002200222206220022502
22222222200000022220022002
22222222200000022220022002
20000222200222222220022002
20000222200222222220022002
22200222200000000000022002
22200222200000000000022002
22200222200222200222222002
22200222200222200222222002
22200222200002200000000002
22200222200002200000000002
20000002222002222222222002
20000002222002222222222002
22222000022000000002222222
22222000022000000002222222
20022000000002222000000002
20022070000002222400008032
22222222222222222222222222
