22222222222222222222222222
20000002200222222222222222
20000002200222222222222222
22222002222000000000000002
22222002222000800000000002
22200000022002200222222222
22200000622002200222222222
22200222222002200220022222
22200222222002200220022222
22200222200002200000000002
22200222200002200000000002
20000002200000022002222002
20050002200000022002222002
20022000000222222002222002
20022000000222222002222002
20022222222002222002222002
20022222222002222072222402
20022002222002222002222222
20022002222002222002222222
20000002222002222000000002
20000002222002222000000002
22222000000000022222222002
22222000000000022222222002
22200000022220022220000002
22200000022220022220000032
22222222222222222222222222
