22222222222222222222222222
20022002222220000222200222
20022002222220000222200222
20022220000222200222200222
20022220000222200222206222
20000220000222200222200222
20000220000222200222200222
22200220022220000002200222
22200220022220000002200222
22200000022220022000000222
22200000022220022000000222
22200002222220022222200222
22240072222220022222200222
22200000000220000222200002
22200000000220000222200002
22200002222220000220022222
22200002222220000220022222
22200000000000000000022002
22200000000080000000022002
22200220022222222220022002
22200220022222222220022002
20000220000000022220022222
20000220000000022220022222
22222220022222200220000002
22222225022222200220000032
22222222222222222222222222
