22222222222222222222222222
20000002222002200000000002
20000002222002200000000002
20022002200222200222222222
20022002200222200222222222
22222000000002200222222222
22222000000002200222222222
20000222222002200220000002
20000222222002200220050002
22222222222002200000022222
22222222222002200000022222
20000000022000000220000002
20040000022000000220000002
22222002222222200222222002
22222002222222200222222002
22200002200222200220022002
22200002200222200220622002
22200000000220022222222002
22200000000220022222222002
22200222200222222000000002
22200222200222222000700002
22200222200000000002222002
22200222200000800002222002
20022220000222222002222002
20022220000222222002222032
22222222222222222222222222
