22222222222222222222222222
20000000022222200002222222
20000000022222250002222222
20000220000000000000000002
20006220000000000000000002
22222220022222200222222002
22222220022222200222222002
22200000022220000222222002
22200000022220000222222002
22200222222000022220022222
22200222222000022220022222
22200002222000022220022222
22200002222000022220022222
22200222222220022000022002
22200222222220022000022002
22200000000220022002222002
22200000000220022002222002
22222002222220000000022002
22222002222220000000022082
20022000000222222220022002
20022000000222222220022002
20000002200000000220000002
20040072200000000220000002
22222002222222200222222002
22222002222222200222222032
22222222222222222222222222
