22222222222222222222222222
20022222200222222222222222
20022222200222222222222222
20000000000000000000000002
20000000000000006000000002
20022222200222222002222222
20022222200222222002222222
20022000000220022222222222
20022000000220022222222222
20022220000000022220000002
20022220000000022225000002
20000222200220022222222002
20000222200220022222222082
22200222200220022002222002
22200222200220022002222002
22200002222220022000022002
22200002222220022000022002
22200222222000022000000002
22200222222000022000000002
22200000022220000002200002
22200000022220000402200002
22200002222220022002222002
22200072222220022002222002
22200222200000022222200002
22200222200000022222200032
22222222222222222222222222
