22222222222222222222222222
20022222222222222222222222
20022222222222222222222222
20022000000000000000000002
20022000000000000000000002
20022222222002200222200002
20022222222002200222200002
20000002222002200222222222
20000002222002200222222222
22222002222002200220022222
22222002222002200220022222
20000000000002200000000002
20000000000002200000000502
20022220022222200222222222
20022220022222200222222222
20000220000222200000000222
20000220000222200000000222
22200222222220000222200222
22200222222220007222240222
22200000022220000002222002
22200000022220000082222002
20022220022000022002222222
20022220622000022002222222
20000220022222222000000002
20000220022222222000000032
22222222222222222222222222
