22222222222222222222222222
20022222222222222220022002
20022222222222222220022002
20000000000000000000022222
20000000000000000005022222
20022222222222222222222002
20022222222222222222222002
20022002200002222222222002
20022002200002222222222002
20000002222220000000000002
20000002222220000000000002
20022000000222200222200222
20022000000222200222200222
22222220022222222220000222
22222220022222222220000222
22200000000000022220000002
22200000000000022220000002
22200002200000000000000222
22200072200000000000000222
22200002222002222002200222
22200002222002222002200222
22200002222002222002200222
22200002222082222002206222
22200002222002222002200002
22200002222402222002200032
22222222222222222222222222
