22222222222222222222222222
20022222222222200222222002
20022222222222200222222002
20022000000000022000000222
20022000000000022000000222
20000002222220022002200222
20000002222220022002200222
22222002222222222002222222
22222002222222222002222222
22222000000000000000000002
22222000000000040000000002
20000002200220022000000002
20000002200220722000006002
22222002222220022002222222
22222002222220022002222222
22200000022220022000022222
22200000022220022000022222
22200000000222222220000002
22200000000222222220000082
20000222200222200222222222
20000222200222200222222222
22222000000000000000022222
22222000000005000000022222
22200002222222222220000002
22200002222222222220000032
22222222222222222222222222
