2222222222222222222222222222
2000022220000000022220000222
2000022220000000022220000222
2220000002200222222220000222
2220000002200222222220000222
2222222002200222200222200222
2222222062200222200222200222
2000000000000222200222200222
2000000000000222240222200222
2000022000000222200222200002
2000022000000222200222200002
2000022222200222200222200002
2000022222200222200222200502
2000022220000000000000000002
2000022220000080000000000002
2002222000022222222222222222
2002222000022222222222222222
2222200000000222222222222222
2222200000000222222222222222
2222222002200000000000000002
2222222002200000000000000002
2000000002222220022222222002
2000000002222220022222222002
2220022222222220022220000002
2220022222222220022220000002
2220022220000000000222222002
2220022220007000000222222032
2222222222222222222222222222
