2222222222222222222222222222
2000000002222220000000000002
2000000002222220000000050002
2220022222200000022220022222
2220022222200000022220022222
2220000000000220022220022222
2220000000000220022220022222
2002222220022222222000000002
2002222220022222222000000002
2002222000000002222220022002
2002222000000002222220022002
2220022222200222200222222222
2220022222200222200222222222
2220022222200000000000000222
2220022222200000000070000222
2220022000000222222222200222
2220022000000222222222200222
2220022002200220000002200222
2220022402200220006002200222
2220022002222222222222222222
2220822002222222222222222222
2220000000022000000000000002
2220000000022000000000000002
2002222220000002222220022002
2002222220000002222220022002
2000000002222000000222222002
2000000002222000000222222032
2222222222222222222222222222
