2222222222222222222222222222
2002222222222220022002222222
2002222222222220022002222222
2000000000000002222002200002
2000000000050002222002200002
2000022002222222200002222002
2000022002222222200002222002
2222222002222000000220000002
2222222002222000000220000002
2222222002222002222220022222
2222222002222002222220022222
2000000002200002222220000222
2000000002200002222220000222
2222222002200000000000000222
2222222002200000600000000222
2220000000000000022222200002
2220000000000000022222200072
2220022220000222200222222002
2220022220000222200222222002
2220022220000220022000000002
2220022220000220022000000002
2220022220022222222002222002
2220822220022222222002222002
2000000220000000022220000002
2000000220000000022220000002
2222200222222222200002222002
2222240222222222200002222032
2222222222222222222222222222
