2222222222222222222222222222
2002222002222222200222222002
2002222002222222200222222002
2002222000000000022000022002
2002222000000000022000822002
2002222220000220022220022002
2002222220000220022220022002
2000000000022220022220000002
2000000000022220022220000002
2220022222222220022222200222
2224022222222220022222200222
2220000222200220000000000222
2220000222200220000000000222
2002222220000222222220000222
2002222220000222222220000222
2220022220000000022000022222
2220022220000000022000022222
2220000222222220000002222002
2220000222222220006002222072
2220022002222000022220000002
2220022002222000022220000002
2220022002222220022000000222
2220022002222220022000000222
2220000000000000000002200222
2220050000000000000002200222
2002222000022222222222200002
2002222000022222222222200032
2222222222222222222222222222
