2222222222222222222222222222
2000000000000220022000022002
2000000000000220022000022002
2222222002200222222000022222
2222222002200222222000022222
2002200222200220022220000002
2002200222200220022220000002
2002200002200000022220022222
2002200002200000022220022222
2220000222200222222220000222
2220000222200222222220000222
2220000220000002200222200222
2220000220000002200222200222
2222200000022000000000000222
2222200000022000000000007222
2002222222222002222220022222
2002222222222002222220022222
2002222222200002222220022002
2002222222200002222220022402
2000000000000222200220022002
2000000000006222200220022002
2002222222222222200000000002
2002222222222222200000000002
2000000222222000000002222002
2000050222222000000002222002
2222222220000002222002222002
2222222220000082222002222032
2222222222222222222222222222
