2222222222222222222222222222
2000000002200002200000000222
2000000002200002200000000222
2002222222222222222222200222
2002222222222222222222200222
2000000220000000022222200222
2000000220000000022222200222
2002200002222220000000000222
2002200002222224000060000222
2002222000022220022002200222
2002222500022220022002200222
2000022222222220022222200222
2000022222222220022222200222
2000000222200000022222200222
2000000222200000022222200222
2222200220000222222000000222
2222200220000222222000000222
2220000000022220000002200222
2220000000022220000002200222
2002222000000222222002222002
2002222000000222222002222002
2000022002200222222002222222
2000022002200222222002222222
2000022002222220000000000002
2000022002222220000000800002
2000022000022220022222222002
2000022000722220022222222032
2222222222222222222222222222
