2222222222222222222222222222
2000000222222220022220022002
2000000222222220022220022002
2220000000000000022220022002
2220000000000000022225022002
2220022220022220022220000222
2220022220022220022220000222
2220022220022222200220000222
2220022220022222200220000222
2220022220000000022220022222
2220022220000000022220022222
2220000002222002222000022002
2220000002222002222000022002
2220022000022222222002222002
2220022000022222222072222002
2220022220022220000000000002
2220022220022220000000000002
2000022220000002200222222002
2000022220000002200222222002
2002200220022002200222222222
2002200220022002200222222222
2002222220022000000220000002
2002222220022000600220000002
2002200000022002222220022002
2002240000022002222220022002
2222200222222000000000022002
2222208222222000000000022032
2222222222222222222222222222
