2222222222222222222222222222
2000000000000220022002222222
2000000000000220022002222222
2222222220022222222002200002
2222222220022222222002200002
2222222220000000000000000002
2222222220000000000000000002
2000000000022222200220000002
2000000000022222200220006002
2220022220000220022222222002
2220022220000220022222222002
2220022222200002222000000002
2220022222250002222000000002
2000000000022222222002222222
2000000000022222222002222222
2222200222222220000002222222
2222200222222220000002222222
2220000222200000022000000002
2220000222200080022000000002
2002200222222002222002222002
2002200222222002222002222002
2222200000022002222002222002
2222200000022002222002222002
2002200220022000022002222002
2002200220022070022002222002
2000000222200222222002222002
2400000222200222222002222032
2222222222222222222222222222
