2222222222222222222222222222
2002222222222220022220000222
2002222222222220022220000222
2002200000000220022000000222
2002200000000220022000000222
2002222222200000022220000002
2002222222200000022220006002
2000022222222220000002222002
2000022222222220000002222002
2000000000000222200222222002
2000000000000222200222222002
2220022220022220000000000002
2220022220022220000000000002
2220000220022222200002222222
2220000220022222200002222222
2000022220000002200002222222
2000822220000002200002222222
2220022002222002222000000002
2220022002222002222000700002
2220000222200002222002222222
2220000222200002222002222222
2220000222222000000002222222
2220000222222000000002222222
2220000000000220022000000002
2220000000050220022000000402
2002222222222220022222222002
2002222222222220022222222032
2222222222222222222222222222
