2222222222222222222222222222
2000000002222002222000000222
2000000002222002222000000222
2222222002222002200222200222
2222222002222002200222200222
2222222002222000022220000002
2222222002222000022220000002
2000022000022220022220022002
2000022000022220022220022002
2000000000022220000000022002
2000000000022220000000022002
2222222220022002222002200002
2222222220822002222002200002
2000022220022220022002222222
2000022220022220022002222222
2222200000022002222002200222
2222200000022002222002200222
2000000222222000000002222002
2000000222222000000072222002
2220022222200002222000000002
2220022222200002222000000402
2220022002222002222002222222
2220622002222002222502222222
2220000000022002222000000002
2220000000022002222000000002
2002222220000000022222222002
2002222220000000022222222032
2222222222222222222222222222
