2222222222222222222222222222
2002222220000222200002200002
2002222220000222200002200002
2000000222200222200222222222
2000000222200222200222222222
2002200222200222200220000002
2002200222200222200220000002
2002200000000222200000022002
2502200000000222200000622002
2002222002200222200220022002
2002222002208222200220022002
2222200002222220000220022222
2222200002222220000220022222
2220000222222220022220000222
2220000222222220022220000222
2220022000000000000222200222
2220022000000000000222200222
2220022222222222200002200222
2220022222222222200002240222
2220022222222000000222200222
2220022222222000000222200222
2220000000000000000222200222
2220000000700000000222200222
2002200222222002222222222222
2002200222222002222222222222
2002200000000000000000000002
2002200000000000000000000032
2222222222222222222222222222
