2222222222222222222222222222
2002222220000000000000000002
2002222220000000000000000002
2000000220000000000220022002
2000000220000000000220022002
2002222222200002200222222222
2002222222200002200222222222
2000022002222222200222200222
2000022002222222200222200222
2220022002222002200002200222
2220022002222002200002200222
2220000002222002222000000222
2220000002222002222000000222
2220022222200002222222200222
2220622222200002222222200222
2000022002200002200222200222
2000022002200002200222200222
2002222220000222200222200222
2002222220800222240222200222
2000000000000222200222200222
2000000000000222200222200222
2002222222222222200222200222
2002222222222222200222200222
2002222222222000000000000002
2002222222222000000000000002
2000000000000002222222222002
2005000070000002222222222032
2222222222222222222222222222
