2222222222222222222222222222
2000000222222002222220022002
2000000222222002222220022002
2220022220022002200220022222
2220022220022502207220022222
2220000000000000000000000002
2220000000000000000060000002
2220000220022220022220022222
2220000220022220022220022222
2000022220022002200220000222
2000022220022002200220000222
2222222000022002200220022222
2222222000022002200220022222
2222222002222220022220000002
2222222002222220022220000002
2000000000000220000000022222
2000000000000224000000022222
2000022222222002222220000222
2000022222222002222220000222
2222222220022222222002200222
2222222220022222222002200222
2220000000022000000222200222
2220000000022000000222200222
2220022000000002200000000002
2220022000000002200000000082
2220022222222222200002222002
2220022222222222200002222032
2222222222222222222222222222
