2222222222222222222222222222
2002222000000220022222222002
2002222000050220022222222002
2002222002222222200000000222
2002222002222222240000000222
2002222000022002222222200222
2002222080022002222222200222
2000000000000000000222200222
2000000000000000000222200222
2222222002200222222220000002
2222222002200222222220000002
2000022002200002222000022222
2000022002200002222000022222
2222200002200000000000000002
2222206002200000000000000002
2002222222200002200222222222
2002222222200002200222222222
2000000222200222200000022222
2000000222200222200000022222
2220022000000222200222222002
2220022000000222200222222002
2220022220022222222002222002
2220022220022222222072222002
2000000000000000000000000002
2000000000000000000000000002
2222222222200222222222222002
2222222222200222222222222032
2222222222222222222222222222
