2222222222222222222222222222
2000022222200002222000022222
2000022222200002222000022222
2220000002222002200220000002
2220000002222002200220000002
2220022000000002222220000222
2220022000000002222220000222
2220022220022222200222200222
2220022220022222200222200222
2220022220022002200222200222
2220022220022002200222200222
2002222000022220000222200222
2002222000022220000222200222
2222222220022002200000000002
2222222220022072200000000002
2000000000022002200222222002
2000000000022002200222222502
2002200220022222200002222002
2002200220022222200002222002
2002200220000000000222200002
2002200220000000006222200002
2002200220022002222220000222
2002200220022002222220008222
2222200222222002222000000222
2222200222222002222000040222
2002200222200002222000000002
2002200222200002222000000032
2222222222222222222222222222
