2222222222222222222222222222
2000000000000222222002222002
2000000000000222222002222002
2220022222222220000000000222
2220022222222220000064000222
2220000222222220022222200222
2220000222222220022222208222
2000000000000222200220000002
2000000000000222200220000002
2222200002200002222000022002
2222207002200002222000022002
2222222222200002200222222002
2222222222200002200222222002
2000022222200002222002200002
2000022222200002222002200502
2000000002200222222000000222
2000000002200222222000000222
2222222000000220022222200222
2222222000000220022222200222
2220022002222000000222200222
2220022002222000000222200222
2220022000000002222222200222
2220022000000002222222200222
2220000002222000000000000222
2220000002222000000000000222
2002222002200222222222200002
2002222002200222222222200032
2222222222222222222222222222
