2222222222222222222222222222
2000000222200000000002222002
2000000222200000000002222002
2220022220000222222222200222
2220022220000222222222200222
2220022002200222200222200222
2220022002200222200222200222
2220022222200000000002200222
2220022222200000700002200222
2220022002222002222000000222
2220022082222002222000600222
2000000000022002200222222222
2000000000022002200222222222
2002222220000002222222222002
2002222220000002222222222002
2000022222200000000000000002
2000022222200000000000000002
2222222002200222200222222222
2222222002200222200222222222
2220000000022222200220000002
2220040000022222200220000002
2002200220000000000000022222
2002200220000000000000022222
2002200222200220022220022222
2002200222200220022220022222
2002200222200222222000000002
2002200222250222222000000032
2222222222222222222222222222
