2222222222222222222222222222
2000022002222002222220000222
2000022002222002222220000222
2220022220000002200222200222
2220022220000502200222200222
2220000000022222200222200222
2220000000622222200222200222
2220022220000222200222200002
2220722220000222200222200002
2222222000022220000002222002
2222222000022220000002222002
2000000002200220022000000002
2000000002200220022000000002
2222222002222220022222222002
2222222002222220022222222002
2222222000000220022220022002
2222222000000220022220022002
2000022222200220022002222002
2000022222200220022002222002
2220022000000000022002222002
2220022000000000022402222002
2220000000022220000000022002
2220000000022220000080022002
2002222220022220022220022002
2002222220022220022220022002
2000022000000222222000022002
2000022000000222222000022032
2222222222222222222222222222
