2222222222222222222222222222
2002222220022002222002222002
2002222220022002222002222002
2000000002222002222002222002
2000000002222002222002222002
2222200222222002222002222002
2222200222222002222002222002
2002200220000000000002222002
2002200220000000050002222002
2222200000022222222000022002
2222200000022222222000022002
2000000222222222222222222002
2000008222222222222222222002
2222200222200000000002222002
2222200222200000000002222402
2002200000000002222000000002
2002207000000002222000000002
2222222002222222200002222002
2222222002222222200002222002
2000000000022002200220022002
2000006000022002200220022002
2222200222200220000222222002
2222200222200220000222222002
2002200220022222200220000002
2002200220022222200220000002
2002200000000002200222222002
2002200000000002200222222032
2222222222222222222222222222
