2222222222222222222222222222
2000000000022220022220000222
2000000000022220022220000222
2220022222222000022220000222
2220022222222080022220000222
2220022220000002222220000222
2225022220000002222220000222
2220022220022002200222200222
2220022220022002200222200222
2000000220022222200002200222
2000000220022222200072200222
2222200000022222222000000222
2222200000022222222000000222
2222200000000000000002200222
2222200004000000000002206222
2002222000000222200222200222
2002222000000222200222200222
2000000002222220000222200222
2000000002222220000222200222
2002222002222220022220000222
2002222002222220022220000222
2002222222200000022220000002
2002222222200000022220000002
2222200220000000022220022002
2222200220000000022220022002
2002200000022222200220022002
2002200000022222200220022032
2222222222222222222222222222
