2222222222222222222222222222
2000022220000222200222222002
2000022220000222240222222002
2220022220022220000000000222
2220022220022220000000000222
2220000000022220022002200222
2220800000022220022002200222
2220022002222222222002222002
2220022002222222222002222002
2000022000000000000002200002
2000022000000000006002200002
2222222002200220000220022222
2222222002200220000220022222
2222200002222220022220000002
2222200002222220022220000002
2000000222222000000222200222
2000000222222000000222200222
2002222000000000000000000222
2002222000007005000000000222
2002200002222222222220022002
2002200002222222222220022002
2002222002222222222220022002
2002222002222222222220022002
2222222002200000000000022222
2222222002200000000000022222
2220000002222222222220000002
2220000002222222222220000032
2222222222222222222222222222
