2222222222222222222222222222
2000022222200002222220000222
2000022222200002222220000222
2220000002222000000222200222
2220000002222000000222250222
2220022222222002200000000222
2220022222222002200000000222
2000000000000002200002222222
2000000000008002200002222222
2002222220022002222002222002
2002222220022002222002222002
2000000220022222222002222002
2000000220022222222002222002
2222222222222220000002222002
2222222222222220700062222002
2002222002200220022002222002
2002222002200220022002222002
2220000002200222222002222002
2220000002200222222002222002
2220022222200222222000000002
2224022222200222222000000002
2220000000000000000222222002
2220000000000000000222222002
2002222002222222200000000002
2002222002222222200000000002
2000022002222000000002222002
2000022002222000000002222032
2222222222222222222222222222
