2222222222222222222222222222
2000022220000000022222222222
2000022220000000022222222222
2220022000022222222000000002
2220022004022222222000000002
2220022002222002222002222222
2220722002222002222002222222
2220000000022002222000022002
2220000000022002222000022002
2220000220000000022220000222
2220000220000000022220000222
2220022220022002200220000222
2220022220022002200220600222
2000022002222002222220000222
2005022002222002222220000222
2220000222222002200222200222
2220000222222002200222200222
2222222220000000000000000222
2222222220000000000000000222
2002200220000222222220022222
2002200220000222222220022222
2002222222222220000220000002
2002222222222220000220000002
2000000000022002222000022002
2000008000022002222000022002
2222222220000000000002222002
2222222220000000000002222032
2222222222222222222222222222
