2222222222222222222222222222
2000022220022002222222222002
2000022220022002222222222002
2220000002222002200000000222
2220000002222002200000000222
2220022002222002222002222222
2220022002222002222002222222
2002222000000000022000000002
2002222000000000022000007002
2220000002222220022222200002
2220000002222220022222200002
2220022220022000000220000002
2220022220022000000220000002
2220022220022002200000022002
2220022220022002200000022002
2220022002222002200222222002
2220022002222502208222222002
2220000002222222200002222222
2220000002222222200002222222
2000022222200222222000000222
2000022222200222222000006222
2002200220000000000002200222
2002200220000000000002200222
2002200000022002222222200222
2002200000022002222222200222
2002222222222000000222200002
2402222222222000000222200032
2222222222222222222222222222
