2222222222222222222222222222
2000000002222220000000000222
2000000002222220000000000222
2002222002200220000222200222
2002222002200220000222200222
2222200000000000000222200222
2222200000000000000222200222
2002200222200222222222200222
2002200222200222222222200222
2220000222200002222000000222
2220000222200002222000000222
2222222220000222222222222002
2222222220000222222222222002
2002222000000000000222200222
2002222060000000000222250222
2000000002222222200000000222
2000000002222222200000000222
2222200222200002200222200222
2222200222200002200222200222
2220000222200000000220000222
2220008222200000000220000222
2220022220022220000222222222
2220022220022220000222222222
2220022220000220022222222002
2220022220000220022222222002
2220000222200000000000000002
2220040222200000000070000032
2222222222222222222222222222
