2222222222222222222222222222
2000000222200002222222200222
2000000222200002222222200222
2222200000022220000002200222
2222200000022220000002200222
2002200222222000000000000222
2002200222222000000000000222
2220000000000002222220022222
2220000000000002222220022222
2220022222200000022222222002
2220022222200000022222222002
2220022000000220000002222002
2220022000000220000002222002
2220022002200222222000022002
2220022002200222222000022062
2000022002222222222220000002
2000022002222222222220000002
2222222000022000000222222002
2222222000022000000222222002
2222222220000000022222222002
2222222220000000022222222002
2000000000022002222000000002
2005000000022002222070000002
2002200222222002222000022002
2002200222222082222000022002
2222200222200002200222222002
2222200222240002200222222032
2222222222222222222222222222
