2222222222222222222222222222
2002222220000220000000000002
2002222220050220000000000002
2002200000000220022222222222
2002200000000220022222222222
2002222222200220000002222222
2002222222200224000002222222
2000022220000222222002200002
2000822220000222222002200002
2002222000000222222000000002
2002222000000222222000000002
2000022222200000000002222222
2000022222200000000002222222
2220022220000000022000000222
2220022220000000022000006222
2220000222222220022222200222
2220000222222220022222200222
2220022222222220000222200222
2220022222222220000222200222
2220000000000000022220000222
2220007000000000022220000222
2222200222200222222220000222
2222200222200222222220000222
2000000002200000000222200222
2000000002200000000222200222
2222200002222222222220000002
2222200002222222222220000032
2222222222222222222222222222
