2222222222222222222222222222
2000022220022220022222200002
2000022220022220022222200002
2002222000022220000000022002
2002222000022220000000022002
2002222220022220000002222002
2002222220022220000002222002
2002200220022222222000000222
2002200220022222222000000222
2000000000022000000000022222
2000000080022000000000022222
2222222220000002222220022002
2222222220000002222220022002
2220022222222002222220000002
2220022222222002222220000002
2220022002200000000222200002
2220022002200000000222200002
2220000000000222222000000002
2220000000000222222000000002
2220022222200222222002200222
2220622222200222222002200222
2220022222200000022222200222
2220022222200000022222250222
2000022000000220022222200002
2000022000000220022222200002
2222222002222220000002222002
2222222002222220040072222032
2222222222222222222222222222
