2222222222222222222222222222
2000000222222000022220000222
2000000222222000022224000222
2000022220000002222000022222
2000022220000002222000022222
2220022222200220022000000002
2220022222200220022000000502
2220000002200222222222200002
2220000002200222222222200002
2220022000000000000002222002
2220022000000060000002222002
2220022220022222222000000002
2220022220022222222000000002
2220022220000000000222222222
2220022220007000000222222222
2220022222222222200000000222
2220022222222222200000000222
2000000002200222222222200222
2000000002200222222222200222
2002222002222000022000000222
2002222002222000022080000222
2002222000000002222002222222
2002222000000002222002222222
2002222002222002222000000002
2002222002222002222000000002
2000022220022002222002222002
2000022220022002222002222032
2222222222222222222222222222
