2222222222222222222222222222
2002222000022002200222200222
2002222000022002200222200222
2000000002222222200222200222
2000000002222222200222200222
2222200000000000000222200222
2222200000600000000222200222
2000000222222222200000000222
2000000222222222200400000222
2002200222222222200222200222
2002200222222222200222200222
2002222220000000000222200222
2002222220000000000222200222
2002222000022222200220000222
2002222070022222200220000222
2222222000000220000220000222
2222222000000220000220000222
2220022220022000000000022222
2220022220022000800000022222
2220022000022220022000000002
2220022000022220022000000002
2220000002222220022220022002
2220000002222220022220022002
2220022222200220022000022002
2220022222200225022000022002
2220000000000220022222222002
2220000000000220022222222032
2222222222222222222222222222
