2222222222222222222222222222
2002200002200222222222200222
2002200002200222222222200222
2002222222200000000002200222
2002222222208000000002200222
2000000000022002222002200222
2000000000022002222002207222
2222200220022002200000000222
2222200220022002200000000222
2220000222222002200220000222
2225000222222002200220000222
2220000000022222200222200222
2220000000022222200222200222
2220000222200222200002200002
2220000222200222200002200002
2222200000000222200002222002
2222200000006222200002222002
2002222222200002222002222002
2002222222200002222002222002
2000022222200222200002200002
2000022222200222200002200002
2220022000000000000222200222
2220022000000000000222200222
2220000002200220000222200222
2220000002240220000222200222
2002222222200222222220000002
2002222222200222222220000032
2222222222222222222222222222
