2222222222222222222222222222
2000000002222220022222200222
2000000002222220022222240222
2220022000000000000000000222
2220022000000000000000000222
2220022002222222222220000222
2220022002222222222220000222
2220022222222220022222200002
2220022222222220022222207002
2220022000000000000000022002
2220022000000000000000022002
2220000000000220022220022222
2220000000000220022220022222
2220022222222220022220000222
2220022222222220022220008222
2220000220022220022002222222
2220000220022220022002222222
2220000000000220022222200002
2220000000000220022222200002
2220000000022220000000000222
2220000000022220000000000222
2220022000022220022222200222
2220022000022220022222200222
2000022002222000022220000002
2000022002222000022220050002
2222222002222000022002222002
2222222002222060022002222032
2222222222222222222222222222
