2222222222222222222222222222
2000000000000000000222200222
2000000500000000000222200222
2220022222200220000222200222
2220022222200220000222200222
2220022222200222222222200222
2220022222200222222222200222
2002222002200222222002200222
2002222002200222222002200222
2002200000000000022000000222
2002200000000000022400000222
2222200000022000022220022222
2222200000022000022220022222
2000000222222220000000000002
2000000222222220000000000002
2222222220000000022222222222
2222222220000000022222222222
2222222220022220000222222222
2222222220022220000222222222
2000000220000222222220000002
2000000220000222222220000002
2222200000000002200220022002
2222200000000002200220022002
2220000222222002222220022002
2220000222222072222220022002
2220022220000000000000022002
2220022220000000600080022032
2222222222222222222222222222
