2222222222222222222222222222
2000000220022002222222222222
2000000220022002222222222222
2002222222222002200000000002
2002222222222002200000050002
2002222000000000000222222002
2002222000000000000222222002
2000000002200222200220022222
2000000002200222200220022222
2222222222200222200220022222
2222222222200222200220022222
2220022002200002222220000002
2220022002200002222220000002
2220022220000002222222200222
2220022220000002222222200222
2000000222222002200002200222
2000006222222002200002207222
2222200222222000000000000002
2222200222222000000000000002
2220000000000002222222222222
2220800000000002222222222222
2220022220022220000000000002
2220022220022220000000000002
2000000220000002222002222002
2000000220000002222002222402
2222222002222000000002222002
2222222002222000000002222032
2222222222222222222222222222
