2222222222222222222222222222
2000022222222222200000000222
2000022222222222250000000222
2220000000000002222220022222
2220006000000002222220022222
2220022222200222222220000002
2220022222200222222220000002
2000022222200220000000022222
2000022222200220000000022222
2002222002200220022220022222
2002222002200220722220022222
2000022002200000000222222002
2000022002200000000222222002
2222222000000002222220000002
2222222000000002222220000002
2220022000022000000000022222
2220022000022000000000022222
2220022002222002222002222002
2220022002222002222002222002
2000000002200000022000000222
2000000002200000022000000222
2002222222200220022002200222
2002222222200220022002200222
2000022222200222222002200222
2000022222200222222002208222
2222222000000002200222200002
2222222000000002200222240032
2222222222222222222222222222
