2222222222222222222222222222
2000022222222220022222222222
2000022222222220022222222222
2002222000000000022000000002
2002222000000000022000000002
2000022220022220022220022222
2000022220022220022220022222
2002222000000222222220022222
2002222000000222222220022222
2000000002200222200000000002
2000000002200222200000000002
2222222222200002200222222222
2222222222200002200222222222
2222222222222002200000000002
2222222222222002200000000002
2000000000000002200002222222
2000000000000002200002222222
2002222222200222222000000222
2002222222200222222000700222
2000000222200000000002222002
2000000222200060000002222402
2220022222222002222000000002
2220022222222002222080000002
2220022000022000000222222002
2220022500022000000222222002
2220000000022222222220000002
2220000000022222222220000032
2222222222222222222222222222
