2222222222222222222222222222
2002222220000002222222222222
2002222220000002222222222222
2000000220022222200000000002
2000000220022222200000000002
2222200220000222200222200222
2222200220000222200222250222
2220000220000220022222200222
2220000220700220022222200222
2220000220000222222002200222
2220008220000222222002200222
2220000000000220022000000222
2220000004000220022000000222
2000000222200000000002222002
2000000222200000000002222002
2222200222222222222222200002
2222200222222222222222200002
2220000220022222222220022222
2220000220022222222220022222
2220000000000000000000022002
2220000000006000000000022002
2220000002200222200220000002
2220000002200222200220000002
2220000002200222200222222002
2220000002200222200222222002
2220022222200222200002222002
2220022222200222200002222032
2222222222222222222222222222
