2222222222222222222222222222
2000000000022222222222200222
2000000000022222222222200222
2220022222222000000000000222
2220022222222000000000000222
2220022222200002222002222222
2220022222200002222002222222
2220022002200002222002222002
2220822002200072222002222002
2220000002222222200002222002
2220000002222222200002222062
2220022002222000022000000002
2220022002222000022000000002
2220022000000222222002200002
2220022000000222222002200002
2220022222200000000002222222
2220022222200000000002222222
2222200000000220022002222222
2222200000000220022002222222
2000000220000222222000000002
2000000220000222222000000402
2220000222200222200000022222
2220000222200222200000022222
2220022220000000022220022222
2220022220000000022220022222
2220022002222222200000000002
2225022002222222200000000032
2222222222222222222222222222
