2222222222222222222222222222
2000022220000222222002200002
2000022220000222222002200002
2002222000022220000002222222
2002222000022220600002222222
2002222220000000000000000002
2002222220000000000000000002
2000000000022222200220022002
2000000000022222208220022002
2222222000000222200222222002
2222222000000222200222222002
2002200000022222200002222222
2002200000022222200002222222
2002222222222000000220000222
2002222222222000000220000222
2220022222222222200220000222
2220022222222222200220000222
2220000000000000000000000222
2220000000000000000070000222
2000022222222220000002200222
2000022222222220000002200222
2220022002222222222222200222
2220022002222222222222200222
2220022220000000000000000222
2220022220000000000004000222
2220000222222222222222200002
2225000222222222222222200032
2222222222222222222222222222
