2222222222222222222222222222
2000000002222000000222200222
2000000002222000000222200222
2220000222222220000222200222
2220000222222220000222200222
2222200000000000000222200222
2222200000000000000222200222
2000000000022220000002200222
2500000000022220000002240222
2222222220022220022222200222
2222222220022220022222200222
2222222220022220022220000002
2222222220022220022220000002
2000000222222220022220022222
2000007222222220022220022222
2002222002200000000000000222
2002222002200000000000600222
2000000000000000000222200222
2000000000000000000222200222
2222222220022222200222200222
2222222220022222200222200222
2220000220022220000222200222
2220000220022220000222208222
2220000000022220000222200222
2220000000022220000222200222
2220022222200002222002200002
2220022222200002222002200032
2222222222222222222222222222
