2222222222222222222222222222
2000000222200222222222222222
2000000222200222222222222222
2002200222200000000000000002
2002200222200000000000000002
2222200222200222222222222222
2222200222200222222222222222
2220000222200002222220022002
2220000222200002222220022002
2000000000000222200002222002
2000000000000222200002222002
2002222002222222222000000002
2002222002222222222000000502
2002222002200000022000000002
2002222002200000022000000062
2002200000000220022000022222
2002200000000220022000022222
2222200222200220022000022002
2222200222200220022000022002
2002222220000220000000022002
2002222220000220000000022082
2220022220022222222220022222
2220022220022222222220022222
2220000000022000000000000002
2220007000022004000000000002
2002222222222002222222222002
2002222222222002222222222032
2222222222222222222222222222
