2222222222222222222222222222
2000000000022000000000022222
2000000000022000000005022222
2220022222222222222220000002
2220022222222222222220000002
2220022222200000022002200222
2220022222200000022002200222
2220000002200222222222200222
2220008002200222222222200222
2000000000000222200002200222
2000000000000222200002200222
2000000222200222222000000222
2000000222200222222000000222
2002222220000000000002200222
2002222220000000000002200222
2002200220022222222222200222
2002200220022222222222200222
2002222000000000022222200222
2002222070000000022222200222
2222222222200222222002200002
2222222222200222222002200002
2220000002222002222002200002
2220000062222002222002200002
2220022000000000000000000002
2224022000000000000000000002
2220022222222002222222222002
2220022222222002222222222032
2222222222222222222222222222
