2222222222222222222222222222
2002222222200222222222222222
2002222222200222222222222222
2000000000000220000000000002
2000000000000220000000040002
2002222222200000000000022002
2002222222200000000000022002
2002222220022222222222222222
2002222220022222222222222222
2000000000022000000222200222
2000000000022000000222200222
2220022000000000000000000222
2220022000000000000000000222
2220022222222222222220000222
2220022222222222222220000222
2000022222200002200220000222
2000022222250002200220000222
2220022002200222222000000222
2220022002200222222060000222
2220000000000000022222200002
2220000000700000022222208002
2220022222222220022222222222
2220022222222220022222222222
2000000220022000000000000002
2000000220022000000000000002
2222200222200002222222222002
2222200222200002222222222032
2222222222222222222222222222
