2222222222222222222222222222
2002222220000000000222222002
2002222220000000000222222002
2000000222222222200220000222
2000000222222222200220000222
2220022222222222200002200222
2220022222222222200002200222
2220000000000002222002200222
2220000000800002222002200222
2222222220000000000000000222
2222222220000000600000000222
2002222222200222222222222222
2002222222200222222222222222
2000000000000000022220022002
2000700000000000022220022002
2220022222200220022000000002
2220022222200220022000000002
2220022222200220000000022002
2220022222200220000000022502
2222222000000222200222222222
2222222000000222200222222222
2002222002222220000002200222
2002222002222220000002200222
2002222002222000022002200222
2002222002222000022002200222
2000000002200222222000000002
2000000002200222222004000032
2222222222222222222222222222
