2222222222222222222222222222
2000000222222222222222222002
2000000222222222222222222002
2220022220000000000000000222
2220022220000000000000000222
2220000002200002222222200222
2220000002200002222222200222
2220022222222002200002222222
2220022222222002200002222222
2220022220022000000222200002
2220022220022000000222200002
2220022220000002200222200222
2220022220000002200222200222
2220022222200002222222200222
2220022222200002222222200222
2220022000000220000002200002
2220022000000220000002200402
2220000002222220022000000002
2220000002222220822000000002
2220022000022222222002222002
2220022060022222222002222002
2222222000000000000002222002
2222222000000000000002222002
2000000000000002200002222222
2000000000700002200002222222
2222222222222002200000000002
2222222222222002250000000032
2222222222222222222222222222
