2222222222222222222222222222
2002222000022220000002222002
2002222000022220000002222002
2002200000022220022002222002
2002200000022220022002222002
2000022220000000022222222002
2000022220000000022222222002
2220022222200222222220022002
2220022222200222222220022002
2220000000000000000220000002
2220000000000000000220000002
2222222220022222200000000222
2222222220022222200000000222
2000022220000220022222200222
2000822220000220022222200222
2002222220022222222222222222
2002222220022222222222222222
2000000000000000000000022002
2000000000000000000000022002
2220022222222222222002222002
2220622222222222222002222002
2220022222200222200002222002
2220022222200222200002222002
2220022000000222222002222002
2220722500000222222002222002
2000022222200000000000000002
2400022222200000000000000032
2222222222222222222222222222
