2222222222222222222222222222
2000000000000000000002222002
2000000000000000000002222002
2220022222200220022222200222
2220022222200220022222207222
2220022002222220022222200222
2220022002222220022222200222
2002222220022220000000000222
2002222220022224000000000222
2222200220022220022222222002
2222200220022220022222222002
2000000000022220022222222222
2000000000022220022222222222
2222200222222220022000000002
2222200222222220022000000002
2222200222200220000000022002
2222200222200220006000022002
2002200000000220000002222222
2002200000000220000002222222
2002222002200220022222200222
2002222002200220022222200222
2000000002200000000000000222
2000000002200000000000008222
2220022000022220000002200222
2225022000022220000002200222
2220022220022002222222200002
2220022220022002222222200032
2222222222222222222222222222
