2222222222222222222222222222
2002200002222220022000022222
2002200002222220022000022222
2002222220000220022002222002
2002222220000220022002222402
2000000000000000000002222002
2000000000000000000072222082
2220022002222220022000000002
2220622002222220022000000002
2220022002222000022222200222
2220022002222000022222200222
2220022222200002200222200222
2220022222200002200222200222
2220000222200002200220000002
2220000222200002200220000002
2222200222200000000002200222
2222200222200000000002200222
2000000002200222200222200222
2000000002200222200222200222
2000022220022222200222200222
2000022220022222200222200222
2220022002200000000222200222
2220022002200000000222200222
2220022222200222200222200222
2220022222250222200222200222
2220022000000222200222200002
2220022000000222200222200032
2222222222222222222222222222
