2222222222222222222222222222
2000022220022222200222200002
2000022220022222200222200002
2220022220000000022000000002
2220622220000000022000000002
2220000000022222222002222222
2220000000722222222002222222
2220000000000222222002200002
2220000000000222222002200002
2000000220000000000002200002
2000000220000000000002200002
2220022222222000000222222222
2220022222222000000222222222
2220000002222002200000000002
2220000002222002200000000002
2220022002222002222002222002
2220022002222002222002222002
2220022222200002222002200002
2220022222200002222002200002
2220022222222222222222200222
2220022222222222222222200222
2220000000022220000222200222
2220000080022220000222200222
2220000220022000000000000222
2220000220022000000500000222
2002222220022222222222200002
2002222224022222222222200032
2222222222222222222222222222
