2222222222222222222222222222
2002200222200220000220000002
2002250222200220000220000002
2002200220022220022222222222
2002200220022220022222222222
2000000220022220000000000002
2000000220022220000000000402
2002200000000222200222222002
2002200000000222200222222002
2002222220022002200220022222
2002222220722002200220022222
2000022000022220000222200222
2000022000022220000222200222
2222222002222000022220000222
2222222002222000022220000222
2002222000000000000222200222
2002222000006000000222200222
2220000002200220000000000222
2220000002200220000000800222
2222222222222220000220000222
2222222222222220000220000222
2002222220022222200222200222
2002222220022222200222200222
2000000000000000000220000002
2000000000000000000220000002
2222222222222222200222222002
2222222222222222200222222032
2222222222222222222222222222
