2222222222222222222222222222
2002222222222222222222200222
2002222222222222222222200222
2000000000000000000000000222
2000000000000000000000000222
2220022222222000022222222002
2220022222222000022222222002
2220022222222220022000000222
2220022222222220022000050222
2002222000000220022222200222
2002222000000220022222200222
2222222002200000022220000002
2222222002200000022220000002
2000000002222002222000022222
2000007002222002222000022222
2002222000000002222000022222
2002222000000002222060022222
2002222000022000022220022002
2002222000022000022220022002
2222222220022220000000000002
2222222220022220000000000002
2220000000000222222220000222
2220000000000222222220000222
2220022220000220000000000222
2220022220000224000000000222
2220022002222220000222200002
2220022002222220800222200032
2222222222222222222222222222
