2222222222222222222222222222
2000000220022222222220022002
2000000220022222222220022002
2002200222200000000220022222
2002200222206000000220022222
2002200222200222200220000002
2002200222200222200220000002
2222200000000220000000022222
2222200000000220008000022222
2222200222200220000222200222
2222200222200220000222200222
2000000222200002222220000222
2000000222200002222220000222
2002222220000222200220000222
2002222220000222200220000222
2002222220000000022222200222
2002222220000000022222200222
2222200220022220022000000222
2222200220022220022000000222
2220000000022000022222200222
2220000000022000022222200222
2000022002222220022220000002
2000022002222220022220000002
2222222000000220000000022002
2222222000050220700000022002
2220000002222002222222222002
2224000002222002222222222032
2222222222222222222222222222
