2222222222222222222222222222
2000000222200002222222200222
2000000222200002222222200222
2002200000000222200002200222
2002200000700222250002200222
2002222220022220000222200222
2002222220022220000222200222
2222222220022220022220000002
2222222220022220022220000002
2220000000000000000000022222
2220000060000000800000022222
2002222000022220000220000222
2002222000022220000220000222
2222222002222220000222200222
2222222002222220000222200222
2000000002200222222002200222
2000000002200222222002200222
2002222222200222200220000002
2002222222200222200220000002
2000000222200220022220022002
2000000222200220022220022002
2002200220000000000222222002
2002200220000000000222222002
2002200000022002200222222002
2002200000022002200222222002
2002222222222002222220000002
2002222222222002222220040032
2222222222222222222222222222
