2222222222222222222222222222
2002222222200222200002222002
2002222222200222200002222002
2002200000000222200222200222
2002200000000222200222200222
2000022002200222200222200222
2000022002200222200222200222
2002222002222222200000000002
2002222062222222200000800002
2000000000022002222220022222
2000000000022002222220022222
2220022220000002222220022222
2220022220000002222220022222
2220000222222222200000000002
2220000222222222200000000002
2220000000000222222002222002
2220000070000222222002222002
2000000222200000000002222002
2000000222200000000002222002
2002222222200220000222222002
2002222222200220000222222502
2222200000000220022220022222
2222200000000220022220022222
2220000222222220000000022222
2220000222222220000000022222
2002222000022000022220000002
2002222000022004022220000032
2222222222222222222222222222
