2222222222222222222222222222
2000000222200000022220000222
2000000222200000022220000222
2002222220000220022220000222
2002222220000220022220000222
2000000220022220022220022222
2000000220022220022220022222
2002200000000222222220000002
2002208000000222222220000002
2002222222200222200000022222
2002222222200222206000022222
2000000222200000000220000002
2000000222200000000220000002
2000000222200222222220022222
2000000222200222222220022222
2002200002222222222222222222
2002200002222222222222222222
2002222002222000000000000002
2002222002222000000000000002
2002200000000002222220022222
2002200000000002222220022222
2222200222200222222220000002
2222200222200222222220700502
2220000222200000000222222002
2220000222200000040222222002
2002222000022222222002200002
2002222000022222222002200032
2222222222222222222222222222
