2222222222222222222222222222
2002222222200002222000000002
2002222222200002222000000002
2000000000000222222220022002
2000000000600222222220022002
2000022220022220000000022222
2000022220022224000000022222
2222222220022222222220000222
2222222220022222222220000222
2222200220000002222220022222
2222200220000002222220022222
2000000000022000000000000002
2000050000022000000000000002
2222222000022220022222222002
2222222080022220022222222002
2220022002222222222220022222
2220022002222222222220022222
2220022002200000000000000222
2220022002200000000000000222
2000000000000222200220022222
2000000000000222200220022222
2002222222200220022220000002
2002222222200220022220007002
2000000222200222222222222222
2000000222200222222222222222
2222222002200000000000000002
2222222002200000000000000032
2222222222222222222222222222
