2222222222222222222222222222
2002222222222220000222200222
2002222222222220000222200222
2000000000000000022222200222
2000000000000000022222206222
2002222222222220022002200222
2002222222222220022002200222
2222222222222220022000000222
2222222222222220022000000222
2220000000000000000002200222
2220000000000000000002200222
2222200222222222222002222222
2222200222222222222002222222
2000000222222002222000000002
2000000222222002222000000002
2002200000000002200222200222
2002200000000002200222200222
2002200222200220000220000222
2002200222200220800220000222
2002222222200222222220000222
2002222222207222222220000222
2000000002200220000000000222
2004000002200220000000000222
2002200222200220022222222222
2002200222200220022222222222
2002222220000220000000000002
2002222220000225000000000032
2222222222222222222222222222
