2222222222222222222222222222
2002222222200002222000022222
2002222222200002222000022222
2000000000000222200000000002
2000000000000222200000000002
2220022220022220000220022222
2220022220022220000220022222
2220022220000222200222222002
2224022220000222200222222002
2000022220000000000222200222
2000022220000000000222250222
2220000220000220022220000222
2220000220000220022220000222
2220022220000220022222200222
2220022220000220022222200222
2002222222200220022002200222
2002222222200220022002200222
2002200000000220000000000002
2002200000000220000000006002
2002200222200222222220022222
2002200222200222222220822222
2222200002200222222000000222
2222200002200222222070000222
2000000222200000000220022222
2000000222200000000220022222
2222222002200222222220000002
2222222002200222222220000032
2222222222222222222222222222
