2222222222222222222222222222
2000000002222222222000022002
2000000002222222222000022002
2220022222200000022220022222
2220022222200000022220022222
2220022222222220022220022002
2220022222222220022220022002
2220000000022220000000022002
2220000000022220000000022002
2000000220022220022002222002
2000000220022220022002222002
2222222220022220022000000002
2222222220022220022000000082
2002200220000000000220022002
2002200220000000000220022002
2220022220022222200222222002
2220022220022222200222222002
2220000000000222200220022002
2224000000000222206220022002
2220022220000220022222222002
2220022220000220022222222002
2220022220000000000000022002
2220022220000000000005022002
2000022220022002222222222002
2000022220022002222222222002
2222222000022000022000022002
2222222000022000022000722032
2222222222222222222222222222
