2222222222222222222222222222
2000000222222220000000000222
2000000222222220000000000222
2002200000000000000222200222
2002200000000000000222200222
2002200002222000000002200222
2002200002222000000002200222
2002222222222002200002200222
2002222222222002200002200222
2222200220000002222002200222
2222200220000082222002200222
2220022222200222222002200222
2220022222200222222002200222
2220000000000000022222200222
2220000000000000022222200222
2000022002200222222220000222
2000622002200222222220700222
2002222002200222200222200222
2002222002200222200222200222
2222222002200000000222200002
2222222002200000000222200002
2220022222200222200222222002
2220022222200222200222222002
2220000000000222222220022002
2220000000000222222220022402
2002222222200000000000022002
2002222222200000000500022032
2222222222222222222222222222
