2222222222222222222222222222
2000000222222222222222200002
2000000222222222222222250002
2220000000000000000002222002
2220000000000000000002222002
2220022222200220000000000002
2220022222200220000060000002
2220000222200222222222222222
2220000222200222222222222222
2220000222200222222222222222
2220000222200222222222222222
2220000222222220000000000002
2220000222222220000000000002
2220022220000000022222222222
2220022220000000022222222222
2000000000000220022220000222
2000000000000220022224000222
2222200222222220022220022222
2222200222222220022220722222
2220000220022000022220000002
2220000220022000022220000002
2220000002222002222220000222
2220000002222002222220008222
2002200220022000000000000222
2002200220022000000000000222
2002200222200000022220000002
2002200222200000022220000032
2222222222222222222222222222
