2222222222222222222222222222
2000022220022220022220022222
2000022220022220022220022222
2220000220000002200220022002
2220000220000002200220022002
2222200222222002200000022002
2222200222222002200000022002
2000000222222000000222222002
2000000222222000000222222002
2222200000000000000222222002
2222200000000000000222222002
2220000222200222222220022002
2225000222200222222220022002
2220000222200002222220000002
2220000222200002222220007002
2222222000022002200000022222
2222222000022002200000022222
2000022222222002200220000222
2000022222222002206220008222
2220000000000002200222222222
2220000000000002200222222222
2220022222200000000000000002
2224022222200000000000000002
2220022000000220022002222002
2220022000000220022002222002
2220022222222220022222200002
2220022222222220022222200032
2222222222222222222222222222
