2222222222222222222222222222
2000000222222222222222222222
2000000222222222222222222222
2220022220000000000000000002
2220022220000000000000000002
2220022222222002222000022002
2220022222222002222000022502
2220022000022000022222222002
2220022000022000022222222082
2220022220022222222222222002
2220022220022222222222222002
2000022000022220000000000002
2000022000022220000000000002
2002222002222220022220022222
2002222002222220022220022222
2000022002200000022220022222
2000022002200000022220022222
2000000002222000000222222002
2000000002222004000222222002
2220000222222000000222200002
2220000222222000000222200002
2220000220000000022222200222
2220007220000000022222200222
2002200222200220000000000222
2002200222200220000060000222
2002200000000222222222200002
2002200000000222222222200032
2222222222222222222222222222
