2222222222222222222222222222
2002222222222000022222222222
2002222222222000022222222222
2000000000022220000000000002
2000000000022220000000800002
2002222002222000022222200002
2002222002222000022222200002
2002222002222000000222222002
2502222002222000000222222002
2002222002222002200220022222
2002222002222062200220022222
2222222000000002200000022002
2222222000000002200000022002
2220000000022222200220000222
2220700000022222200220040222
2220022220000222222220000222
2220022220000222222220000222
2220022000022220022222222222
2220022000022220022222222222
2220022000000000000000000002
2220022000000000000000000002
2220022002222000000222200222
2220022002222000000222200222
2220000220000002200222200222
2220000220000002200222200222
2220000222222002200222200002
2220000222222002200222200032
2222222222222222222222222222
