2222222222222222222222222222
2000000002222000022000022222
2000000002222500022000022222
2002200220022220022002222002
2002200220022220722002222002
2222200222200000022002222002
2222200222200000022002222002
2222200222222002222002222002
2222200222222002222002222002
2000000000000000000002200002
2000000000000000000002200002
2002222222200002222000000222
2002222222200002222000000222
2002222222222222200002200222
2002222222222222200002200222
2000000000022222200222200002
2000000080022222200222200002
2222200222222002200002222222
2222200222222002200002222222
2222222220022002222002222002
2222222220022002222002222002
2000022220000000000000000222
2000022220000000000000000222
2220022220022222222220022222
2224022220022222222220022222
2220000000022220000000000002
2220006000022220000000000032
2222222222222222222222222222
