2222222222222222222222222222
2002222222200222200000000002
2002222222200222250000000002
2000000000000220022222222002
2000000000000220022222222002
2002200222200222222222222002
2002200222206222222222222072
2222222220000000000000000002
2222222220000000000000000002
2220022000022220022220022222
2220022000022220022220022222
2220000002222000022220000222
2220000002222000022220000222
2220022002222002222222200222
2220022002222002222222200222
2220022000022222200000000222
2220022000022222200000000222
2220022000022222222002200222
2220022000022222222002200222
2000000220022000022222200222
2000000220022000022222200222
2222200220000220022002200002
2222200220000220022002200402
2222200222200220000220000002
2222200222200220008220000002
2000000222200000000222222002
2000000222200000000222222032
2222222222222222222222222222
