2222222222222222222222222222
2000000222222222222222200002
2000000222222222222222200002
2002200000000000000000022222
2002200000000000000000022222
2222200220022222200222222002
2222200220022222200222222002
2222222220022220000002200002
2222222220022220000072200002
2000022220022222200002222002
2000022220022222200002222002
2002222222222000000222200002
2002222222222000000222200002
2000000000000002200000000222
2400000000000002200000000222
2222222222222222200222200222
2222222222222222200222200222
2002222222222222222002200222
2002222222222222222002200222
2000000000000000022002200002
2000000000000500022002206002
2220022002200000000000000222
2220022002200000000000800222
2220022222200222200000000222
2220022222200222200000000222
2220022220000002222222200002
2220022220000002222222200032
2222222222222222222222222222
