2222222222222222222222222222
2002222000000000022220000222
2002222000000000022220040222
2000000220022220022002200222
2000000220022220022002200222
2222200220022222222222200222
2222206220022222222222200222
2220000000000000000002200222
2220000000000000000002200222
2220022000022220022222200222
2220022000022220022222200222
2220022000022222222222200222
2220022000822222222222200222
2220022220000002200002200222
2220022220000002200002200222
2002222220000000000220000222
2002222220000000000220000222
2222200000022002200220022222
2222200000022002200220022222
2002222002222002200000000002
2002222002222002200000050002
2002222002222002200220022222
2002222002222002200220022222
2000000000000222200220022222
2000000000000222200220022222
2222200222222002200220000002
2222200222222002200220700032
2222222222222222222222222222
