2222222222222222222222222222
2002222002222002222002222002
2002222002222002222002222402
2000000000022002222002222002
2000000000022002222002222002
2222222000000002222002222002
2222222000000002222002222002
2222222222200002222000000002
2222222222207002222000000002
2000000000000000022220000002
2000000000000000022220000002
2002222220022220022222200222
2002222220022220022222200222
2222222000000222222002200222
2222222000000222222002200222
2220000002222222222000000222
2220000002222222222000000222
2220000222222000022222200222
2220000222222005022222208222
2222200000022220000222200222
2222200000022220000222200222
2000000000000000000222200002
2000600000000000000222200002
2220022220022220022222222002
2220022220022220022222222002
2220022220022220000000000002
2220022220022220000000000032
2222222222222222222222222222
