2222222222222222222222222222
2002222002222002222002222002
2002222502222002222002222002
2002222002222002222002222002
2002222002222002222002222002
2002222002222002222002222002
2002222002222002222002222002
2002200000022002200000022002
2002200000022002200000022002
2000000220000000000000000002
2000000220000000000080000002
2222200222200222222220000002
2222207222200222222220000002
2002200222200222222220022222
2002200222200222222220022222
2220000222222220000000000222
2220000222222220000000000222
2220022000022220000222200222
2220022000022220006222200222
2220022000022000000222200222
2220022000022000000222200222
2220022220022222200222200002
2220022220022222200222200002
2220022000022220000002222002
2220022400022220000002222002
2220000000022220000002222002
2220000000022220000002222032
2222222222222222222222222222
