2222222222222222222222222222
2002222002222222222222222002
2002222002222222222222222002
2002222002200000000000022002
2002222002200000000000022002
2000022002222220022220000002
2000022002222220022220007002
2220000002222000022222222222
2220000002222000022222222222
2220022222222002222000000002
2220022222222002222000000002
2220022000000000022002222002
2220022000000000022502222002
2220022220022000022222200002
2224022220022000022222206002
2000022220022002222222200222
2000022220022002222222200222
2220022222222002200000000222
2220022222222002200000000222
2220022002222000000222200222
2220022002222000000222200222
2000000000000000000002222222
2000000000000000800002222222
2002222000022220000000000002
2002222000022220000000000002
2222200000000222222222222002
2222200000000222222222222032
2222222222222222222222222222
