2222222222222222222222222222
2002222220000002222002222222
2002222225000002222002222222
2000000000022222200220000002
2000000000022222200220000002
2222222000022220000220000002
2222222000022220000220040002
2220000002222220000000022222
2220800002222220000000022222
2220022222200000022002222222
2220022222200000022062222222
2220022222222002222002200002
2220022222222072222002200002
2000000000000002222000000002
2000000000000002222000000002
2222200222222222200002222002
2222200222222222200002222002
2002200222222222200000022222
2002200222222222200000022222
2002222220000000000002200222
2002222220000000000002200222
2220022222222222222002222002
2220022222222222222002222002
2220000000000222222000000002
2220000000000222222000000002
2002222222200000000002222002
2002222222200000000002222032
2222222222222222222222222222
