2222222222222222222222222222
2000000000022220022222222222
2000000000022220022222222222
2002222220000002200000000002
2002222220000002200000000002
2222222002222002222002200222
2222222002222002222082200222
2220022000000002222002200222
2220022000000002222002200222
2220022220022220000002200222
2220022220722220000002200222
2220000000000000022222200222
2220000000000000022222200222
2220000002222222222220000002
2224000062222222222220000002
2220000222222222200222222222
2220000222222222200222222222
2000000000000000000222200222
2000000000000000000222200222
2222200002222002200002200222
2222200002222002200002200222
2220000222222222222000000222
2220000222222222222000000222
2000000000000220022222200222
2000000000000220022222200222
2002222222200000022220000002
2002222222250000022220000032
2222222222222222222222222222
