2222222222222222222222222222
2000000222222220000220022222
2000000222222220000220022222
2002222220000000022220022002
2002222220000000022220022002
2002222220022222222220000002
2002222225022222222220000002
2002200000022222200222200222
2002200000022222200222200222
2002200222222000000000000222
2002200222222000000000008222
2000000000000222222000022002
2000000000000222222000022002
2220022222222222222002222002
2220022222222222222002222002
2220022222222000000000000222
2220022222222060000000700222
2000022000000002222002200222
2000022000000002222002200222
2002222222222222222002222002
2002222222222222222002222002
2002200222222220022002222222
2002200222222220022002222222
2000000000000000000000000002
2400000000000000000000000002
2222222222222222222222222002
2222222222222222222222222032
2222222222222222222222222222
