2222222222222222222222222222
2000022220022220022002200222
2000022220022220022002200222
2220022000000220022002200222
2220022000000220022002200222
2220000002200000022222200222
2220000002200000022222200222
2220022222222220000002200222
2220022222222220000002200222
2000000000022000022002200222
2000000000022000022002200222
2222200222222002222000000222
2222200222222002222000000222
2220000002222000022222222222
2220000002222000022222222222
2220022220000220000222200002
2220022220000220000222250002
2220000222222220000222222002
2220000222222220000222222002
2220022220000000000000000002
2220022220006000000000000002
2222222000022220000222222222
2222222000022220800222222222
2002222220022222222222222222
2002222220022222222222222222
2000000000000000000000000002
2000000000000000000400700032
2222222222222222222222222222
