2222222222222222222222222222
2002222222222002200000000222
2002222222222002200000040222
2000000000000222200222200222
2000000000006222200222200222
2222222222200222200222200222
2222222222200222200222200222
2222222222200222200222200222
2222222222200222200222200222
2000000002200222222222200222
2000000002200222222222200222
2002200000000000022002200222
2002200000000000022072200222
2002222220000220000002200222
2002222220800220000002200222
2000000222222220000000000222
2000000222222220000000000222
2220022222222220000220000222
2220022222222220000220000222
2220000000000222222222200222
2220000000000222222222200222
2000000000000002222000000222
2000000000000002222000000222
2222200000022002222220000222
2222200000022002222220000222
2000022222222002200000000002
2000022222222002200500000032
2222222222222222222222222222
