2222222222222222222222222222
2000022222200002222220022222
2000022222200002222220022222
2220000000000222200220022002
2220000000000222200220022002
2220022222200000000000000002
2220022222200000000000040002
2220000222200220022002222222
2220000222200220022002222222
2222200222222220022000000222
2222200222222220022000000222
2002222220022220022222200222
2002222220022220822222200222
2002222000000000000222200222
2002222000000000000222200222
2002200002222222222222200222
2002200002222222222222200222
2002200222200222200002200222
2002200222200222200002200222
2000000220022000000222200222
2000000220022500000222200222
2000022220022222200000000222
2000022220022222200000007222
2220022000022222222220022222
2220022000022222222220022222
2220022220000000000000000002
2220022220000000006000000032
2222222222222222222222222222
