2222222222222222222222222222
2000000000000222222002222002
2000000000000222222002222002
2220022222222220000002222002
2220022222222220000502222002
2220022222222220022220022002
2220022222222220022220022002
2220022000000000000222222002
2220022000000000000222222402
2000000002222002200000000002
2000700002222002200000000002
2002200002222222222222222002
2002200082222222222222222002
2222200000000000022002222002
2222200000000000022002222002
2222222220022220022002222002
2222222220022220022002222002
2000022222222000000002222222
2000022222222000000002222222
2000000000000002200222200222
2000000000600002200222200222
2002222222200222200222200222
2002222222200222200222200222
2002200222200222222222200222
2002200222200222222222200222
2002222000000000000000000002
2002222000000000000000000032
2222222222222222222222222222
