2222222222222222222222222222
2000000222222002222220022002
2000000222222002222220022002
2002222220000002200000022002
2002222220800002200000022002
2002200220022000000222222222
2002200220022000000222222222
2000022222222002222002200002
2000022222222002222002200002
2220022002222002222002222002
2220022002222002222002222002
2220000000000002200220022002
2220000000000002200220022002
2002222002222000000220000002
2002222002222000750220006002
2002222002222002222000022002
2002222002222002222000022002
2220022002222002200220022222
2220022002222002200220022222
2220000002222002200220000222
2220000002222002200220000222
2000022002222002222222200222
2000022002222002222222200222
2222222002222000000002200222
2222222402222000000002200222
2002200002200222222000000002
2002200002200222222000000032
2222222222222222222222222222
