2222222222222222222222222222
2000000222222220022000022222
2000000222222220022000022222
2002222220000000022002222002
2002222220000000022002222002
2000022002222002222000000002
2000022002222002222000000002
2220022222222000022222200222
2220022222222080022222200222
2220000000022220022222200222
2220000000022220022222200222
2220022220000000000000000222
2220022220050000000000000222
2220022222222002200000022222
2220022222222002200060022222
2220000002222002200220022002
2220000002222002207220022002
2220022002222002200222222002
2220022002222002200222222002
2220022002222002200220000002
2220022002222002200220000002
2000000222200002200000022002
2000000222200002200000022002
2002200222200222222222222002
2002240222200222222222222002
2002222002200000000222200002
2002222002200000000222200032
2222222222222222222222222222
