2222222222222222222222222222
2002222220000002222220000222
2002222220000002222220000222
2000000220022222200222200222
2000000220722222200222200222
2000000000000000000222200222
2000000000000000000222200222
2222200222222222200000000222
2222200222222222200000006222
2222200220022002222002222002
2222200220022002222002222002
2000000000022220022000000222
2000000000022220022000000222
2222200220000220000000000222
2222200220000220000000000222
2002200222200002222002222222
2002200222250002222002222222
2002200222222222200000000002
2002200222222222208000000002
2220000000022222200222222002
2220000000022222200222222002
2220022222222000000222200222
2220022222222000000222200222
2220022222222002200000022222
2220022222222002200000022222
2220022000000002222220000002
2220022004000002222220000032
2222222222222222222222222222
