2222222222222222222222222222
2000000222222002222222222222
2000000222222002222222222222
2222200220022000000000000002
2222200220022000000000000002
2000000000022000022000022002
2000000000022000022000022002
2222222220022002222220022222
2222222220022002222220022222
2222200220022000000220000222
2222207220022000000220000222
2000000220000002200222200222
2000000220000002200222200222
2002200220022222200222222222
2002200220022222200222222222
2002200000022002200000000002
2002200000022002200000000002
2000022222200222222222200002
2000022222200222222222200002
2220022222222000000222200222
2220022222222000050222200222
2220022000000002200222200222
2220022000000002208222200222
2220000000000222200222222222
2220000000000222200222222222
2002222222222220000000000002
2002222222222224000060000032
2222222222222222222222222222
