2222222222222222222222222222
2002222220000000000000000002
2002222220000000000000000502
2000000000022222222222222002
2000000000022222222222222002
2222200000000220000000000002
2222200000000220000000000072
2220000002222002222222222222
2220000002222002222222222222
2220000002200222222222222222
2220000002200222222222222222
2220022220022000000000000002
2220022220022000000080000002
2220022222222002222002222222
2220022222222002222002222222
2220000000022000022002222222
2220000000022000022002222222
2220022220022220022222200002
2220022220022220022222200002
2220000220000000022222200222
2220600220000000022222200222
2222200220022220000000000222
2222200220022220000000000222
2002200220022220022222200222
2402200220022220022222200222
2000000222222000000222200002
2000000222222000000222200032
2222222222222222222222222222
