2222222222222222222222222222
2000000002222000000000000222
2000000002222000000000000222
2222222002222002222222200222
2222222002222002222222200222
2222222000022222200002200222
2222222000022222200002200222
2000022002222220022002200222
2500022002222220022002200222
2220000000000000022222200222
2220006000000000022222200222
2220022222200000000000000222
2220022222200000000000000222
2220022002222222200222200002
2220022002222222200222200002
2222222220022222200222222222
2222222220022222200222222222
2002200220022002200220000222
2002200220022002200220000222
2002200220022000000000022002
2002200220022080000000722002
2000000000000002222220022002
2000000000000002222220022002
2222200222222000000220022222
2222200222222000000220022222
2000000002200222222220000002
2400000002200222222220000032
2222222222222222222222222222
