2222222222222222222222222222
2000000000000002222000000222
2000000000000002222000000222
2220022222222002222002200222
2220022222222002222002200222
2220022220000002200002222222
2220022220000082200002222222
2220022000022222222002222002
2220022000022222222002222002
2220022222222220000000000002
2220022222222220006000000002
2220000222200000022002222002
2220000222200400022002222002
2220022222222222222000022002
2220022222222222222005022002
2220000000022000000002222002
2220000000022000000002222002
2220022220022222200000022222
2220022220022222200000022222
2000022220000222200000000222
2000022220007222200000000222
2002222000022222222222200002
2002222000022222222222200002
2002222000000000000000000002
2002222000000000000000000002
2002222000022222222222222002
2002222000022222222222222032
2222222222222222222222222222
