2222222222222222222222222222
2000000222200220022222222002
2000000222200220022222222002
2222200222200222200000000222
2222200222200222200000000222
2220000222200222200222200222
2220000222200222200222200222
2220000220000222200002200002
2220000220000222200072200062
2000000000000222222222222002
2000000000000222222222222002
2002222220022220000000000002
2002222220022220000000000002
2000022000000000022222200002
2000022000000000022222200002
2222222000022002200220000222
2222222000022002200224000222
2220022002222222222220022222
2220022002222222222220022222
2220000000000220000000000002
2220000000000220000000008002
2222222002222220022222200222
2222222002222220022222200222
2000000000022220000222200222
2000000005022220000222200222
2222222220022002222220000002
2222222220022002222220000032
2222222222222222222222222222
