2222222222222222222222222222
2002222002222002200222200222
2002222002222002200222200222
2000000220000222200000000222
2000000225000222200000000222
2222200220000000000222222222
2222200220700000000222222222
2002200002222222200222222002
2002200002222222200222222002
2000000220022002200000022002
2000000220022002200000022002
2220000222200222222002222002
2220000222200222222002222002
2220022220000220000000000002
2220022220000220800000000002
2220022220022220022222222002
2220022220022220022222222002
2220022220022220000220022002
2220022220022220000220022062
2220000000000220000222222002
2220000000000220000222222002
2220022002200000022220000002
2220022002200000022220000002
2220022002222220022220022002
2220022002222220022224022002
2220022000022220000222222002
2220022000022220000222222032
2222222222222222222222222222
