2222222222222222222222222222
2000000002222000000002222002
2000000002222000000002222002
2222222002222220022002200222
2222222002222220022002200222
2222222002200222222000000222
2222222002200222222000000222
2000000000000000000002222222
2000000000000000000002222222
2000022222222002222000000002
2000022222222002222000000072
2220022002222002222222200222
2220022002222002222222200222
2220022220000000000222200222
2220022220000000600222200222
2220022220022220000222200222
2220022225022220000222200222
2002222222222222200002222002
2002222222222222200002222002
2220000000000000000002200222
2220800000000000000402200222
2220022222222222200000000222
2220022222222222200000000222
2220000222200002200222222222
2220000222200002200222222222
2220000002222000000000000002
2220000002222000000000000032
2222222222222222222222222222
