2222222222222222222222222222
2000000000000000000002222002
2000000000000000000002222002
2222200220022222222000000222
2222200220022222222000000222
2222200222222002222222200222
2222200222222002222222200222
2000000222222000000002222222
2000000222222000000002222222
2002200000000002222000000002
2002200000007002222000000002
2002222222222002200000022002
2002222222222002200000022002
2002222222222002222222222002
2002222222222002222222222002
2000000000000220022222222222
2000000000000220022222222222
2222222002200222200000000222
2222222002206222200005000222
2002200002222222222222200222
2002200002222222222222208222
2222200222222000000000000002
2222200222222000000000000002
2000000000000002200000022002
2000000000000002200000022002
2222222222222222200000022002
2222222222222222200004022032
2222222222222222222222222222
