2222222222222222222222222222
2000000000000000022220022002
2000000000000005022220022002
2220022222222000022220022002
2220022222222000022220022062
2220022222222220022220022222
2220022222222220022220022222
2000000000000220022000000002
2000000000000220022000000002
2002222002222220022002222222
2002222002222220022002222222
2002222220000220022002222222
2002222220000220022002222222
2002200222222220022000000002
2002200222222220022000000002
2222200000000220000000022222
2222200000000220000000022222
2220000222200000022220022222
2220000222200000022220022222
2220022222222222222000000002
2220022222222222222000000002
2220000000000222200002222222
2220000000040222200082222222
2222200222200222200222222222
2222200222200222200222222222
2000000000000222200000000002
2000007000000222200000000032
2222222222222222222222222222
