2222222222222222222222222222
2000022002200000022002222002
2000022002200000022002222002
2220022222200220022220000222
2220022222200220022220000222
2220022000000222222220022222
2220022000000222222220022222
2220022220000222200000000002
2220022220000222200000000002
2220022220000002222002222002
2220022220008002222002222002
2220000000000000022002222002
2220000000000000022002222002
2220022222222220000002222002
2220022222222220000002222002
2000000222200222222222200002
2000040222200222222222200002
2222222002200222222222200222
2222222002200222222222200222
2222200000000220000002200222
2222200000000220000002200222
2000000220000220022222200222
2000007220000220022222200222
2222200220000000000000000222
2222200220600500000000000222
2000000222222220022222200002
2000000222222220022222200032
2222222222222222222222222222
