2222222222222222222222222222
2000000000022220000222200002
2000000000022220000222200002
2220022220000000022220000222
2220022220000070022220000222
2220022002200002222000000222
2220022002200002222000000222
2220022222222002200222200002
2220022222222062200222200002
2220022000000000022222222002
2224022000000000022222222002
2000022002222000000000022002
2000022002222000000000022002
2222222000000222200220000002
2222222000000222200220000002
2220022002222220000222222002
2220022002222220008222222002
2220022000022222222222222002
2220022000022222222222222002
2220000000000002222000000002
2220000000000002222000000002
2220022222222002222002222222
2220022222222002222002222222
2220022220000002222002222222
2225022220000002222002222222
2220022220022222200000000002
2220022220022222200000000032
2222222222222222222222222222
