2222222222222222222222222222
2000000002222000022220022002
2000000002222000022220022002
2222200222200222200000022002
2222200222200222207000022002
2220000000000222200222222222
2220000000000222200222222222
2000022222222222200000000002
2000022222222222200000000002
2000000222222002200222222002
2000000222222002200222222002
2222200000000002200002222222
2222200000000002200002222222
2220000222222002222002200222
2220000222222002222002200222
2000022002222002222002200222
2000022002222002222002200222
2220022002222002222000000002
2220022002222082222000000062
2220000002222002222222222002
2220000502222002222222222002
2220000002222000000222200002
2220000002222000000222200002
2220022220022222200000000002
2220022220022222200004000002
2220000222200000000222222002
2220000222200000000222222032
2222222222222222222222222222
