2222222222222222222222222222
2000000000022222222220000002
2000000005022222222224000002
2220022222222000000000022222
2220022222222000700080022222
2220022002200002222222200222
2220022002200002222222200222
2220022222222002222000000222
2220022222222002222000000222
2220022000000000022220022222
2220022000000000022220022222
2220022002222222222000022002
2220022002222222222000022002
2220000002222222200220000002
2220000002222222200220000002
2220022222200002200222200002
2220022222200002200222200002
2220022222200000000220000002
2220022222200000000220000002
2220000000000222200000022222
2220000000000222200000022222
2220022222222002200220022222
2220022222222002200220022222
2220022222222220000220000002
2220022222222220006220000002
2000000000000220000002222002
2000000000000220000002222032
2222222222222222222222222222
