2222222222222222222222222222
2000022222200000000002222002
2000022222200000000002222002
2220000000000220022222200222
2220000000000220022222250222
2220022220022220000222200222
2220022220022220008222200222
2220022220022222200000000222
2220022220022222200000007222
2220022220022002222222222222
2220022220022002222222222222
2220022220000000000000022002
2224022220000000000000022002
2220022220000222200222222002
2220022220000222200222222002
2220022220022220000000022002
2220022220622220000000022002
2220022000022220000002222002
2220022000022220000002222002
2220022000000002222220022002
2220022000000002222220022002
2220000222200000000002222002
2220000222200000000002222002
2220022220000220000000000002
2220022220000220000000000002
2220022220022220022222222002
2220022220022220022222222032
2222222222222222222222222222
