2222222222222222222222222222
2002222002222222222222200222
2002222002222222222222200222
2000022000000000000002200222
2000022000000000000002208222
2000000002222222222222200002
2000000002222222222222200002
2222222002200002222222222002
2222222002200002222222222002
2220000002222000000000000002
2220000002222000000070000002
2220022002222002200222200222
2220022002222002200222250222
2222222002200222200222200222
2222222002200222200222206222
2002222000022002200222222222
2002222000022002200222222222
2002200002222220000000000002
2002200002222220000000000002
2000000222200220022222222002
2000000222200220022222222002
2220000222200000022222222002
2220000222200000022222222002
2222200000000222222000000002
2222200000000222222000000002
2000000000000002222002222002
2000000000000002222402222032
2222222222222222222222222222
