2222222222222222222222222222
2002222222222222222222222222
2002222222222222222222222222
2000000000000000000000000002
2000000000000000000000000002
2220022222200222222222222222
2220022222200222222222222222
2220022002200002222222222222
2220022002200002222222222222
2000000220000002200000000002
2000007220000002200080000002
2222222222222000000222222222
2222222222222000000222222222
2222200002200000022222200222
2222200002200000022222200222
2000000002200222222002200222
2005000002200222222002200222
2222222000000222222002200222
2222222000600222222002200222
2220000002200000000000000222
2220000002200000000000000222
2220000222200000022220000002
2220000222200000022220000402
2222200222222000000002222222
2222200222222000000002222222
2000000000022222222000000002
2000000000022222222000000032
2222222222222222222222222222
