2222222222222222222222222222
2000000222200222222222222222
2000000222200222222222222222
2222200000000000000000000002
2222200000000000000000000002
2222222222200222222222200002
2222222222200222222222200002
2000022002200000022222222222
2000022002200000022222222222
2000000222222002222000022222
2400000222222002222000022222
2002200000000002222000000002
2002200000000002222000000002
2222222222200222200000022222
2222222222200222200000022222
2220022220000000000000000222
2220022220000500000000000222
2220000222200222222220022222
2220000222200222222220022222
2222200002200222200220000002
2222200002200222200220800002
2000000002200220000222200222
2000000062207220000222200222
2220022000000000022002200222
2220022000000000022002200222
2220022222222220022002200002
2220022222222220022002200032
2222222222222222222222222222
