2222222222222222222222222222
2002222222222222222222222002
2002222222222222222222222002
2000000000000000000000000222
2000000000000000000004000222
2220022222200222222222200222
2225022222200222222222200222
2220022222200002222222200222
2220022222200002222222200222
2222222002222000000002222222
2222222002222000000002222222
2002222000000002222222222002
2002222000000002222222222002
2000000000022222200000000002
2000000000722222200000000002
2002222002222220000000022222
2002222002222220000000022222
2000022002200222200000022002
2000022002200222200000022062
2002222000000002222220022222
2002222000000002222220022222
2222222220000000022220022002
2222222220000000022220022002
2220000000000000000000000002
2220000000000000008000000002
2002222222222220000002222002
2002222222222220000002222032
2222222222222222222222222222
