2222222222222222222222222222
2000000222200220022220000002
2000000222200220022220000002
2222200000000222200002222222
2222200000000222200402222222
2222222220022222200000000002
2222222220022222200000006002
2000000000000002222222200002
2000000000000002222222200002
2002222220022220022220022002
2002222220022220022220022002
2002222000022222200220022002
2002222000022222200220022002
2222222002222000000000000002
2222222002222005000000800002
2220000000022222222002222222
2220000000022222222002222222
2000022222222220022002200222
2000022222222220022002200222
2220000000000002222002222002
2220007000000002222002222002
2220022222222002200002222002
2220022222222002200002222002
2220022222222000000000000002
2220022222222000000000000002
2220000000022220022222222002
2220000000022220022222222032
2222222222222222222222222222
