222222222222222222
200222222002200002
200222222002200002
200000000002222002
200000000002222002
222222200222200222
222222206222240222
222222200222200222
222222200222207222
200000000222200222
200000000222200222
200220022222200222
200220022222200222
200220000000000222
200220800000000222
222220022220000002
222225022220000032
222222222222222222
