222222222222222222
200222222220022002
200222222220022002
200000000000022002
250000000000022002
222220022220022002
222220022220022002
222000022220022222
222000022220022222
200222222000000002
200222222000800002
222222222002200222
222222222002200222
200000000002200222
200000740062200222
222222222002200002
222222222002200032
222222222222222222
