222222222222222222
200222200222222222
200222200222222222
200002200000000002
200002200000000002
222002200222222222
222002200222222222
222000000222200222
222000000222250222
222000022220000222
222000622220800222
222220022222200002
222220022222200002
200000000002222002
200000000072222002
222222222000000002
222222222000040032
222222222222222222
