222222222222222222
200000000000000002
200005000004000002
222220022222222222
222220022222222222
200220022222200222
200220022222200222
222220022000000222
222220022080006222
200000022220000222
200000022220000222
200222222220022222
200222222220022222
200000000000000002
200000000000700002
222222222222222002
222222222222222032
222222222222222222
