222222222222222222
200000000222222002
200005000222222002
222222200000000222
222222200000000222
200220022220022222
200220022220022222
200000000000000002
200000700000800002
222222200222222222
222222200222222222
222222200222222222
222222206222222222
200000000000000002
240000000000000002
200222222222222002
200222222222222032
222222222222222222
