222222222222222222
200002222002222002
200002222002222002
222000000002200002
222000040002200002
222002222222200222
222002222222200222
222000000002200222
222000000002200222
222002222002200222
222002222072208222
222002200000000222
222002206000000222
222002222002200002
222002222502200002
222002222002222002
222002222002222032
222222222222222222
