222222222222222222
200002222222222002
200002222222222002
222000000000000222
222000000000000222
222002222222200222
222002222222200222
222002200220000002
222002200220600002
222002200220022002
222002200220022002
222002222220022222
222002222220022222
200002200000000002
250002200070008002
222222200002222002
222222200402222032
222222222222222222
