222222222222222222
200002222000022222
200002222000022222
222000000002222002
222000000002222002
222002222002200002
222502222002200002
222002222000000222
222002222000000222
200002200222200222
200002207222208222
222222222222200222
222222222222200222
222000000000000002
222400000000600002
222002222002222002
222002222002222032
222222222222222222
