222222222222222222
200222222222222222
200222222222222222
200000000000000002
200000000000000002
200222200222222002
200222207222222002
200222200222222002
200222200222222002
200222200220000002
200222206220850002
200222200222222002
200222200222222002
200002222222222002
200002222222222002
200222200000000002
240222200000000032
222222222222222222
