222222222222222222
200002222000022002
200002222000022002
222000000002222222
222000000002222222
222002200000000002
222002200000006002
222002222220022222
222002222220022222
222002222000000002
222002222000700002
222002222002200222
222002222402200222
222002222222200222
222002222222208222
222000000222200002
222000050222200032
222222222222222222
