222222222222222222
200222222222222222
200222222222222222
200000000000000002
200000000000000402
222222200222222002
222222200222222002
200220000000022222
200220700000822222
222000022000022222
222000022000022222
222220022220000002
222220022220000002
200000022000022002
200500622000022002
222222222002222002
222222222002222032
222222222222222222
