222222222222222222
200222200220022222
200222200220022222
200000000222200002
200000000222200002
200222200222200222
200222200222240222
222220000222200222
222220007222200222
222000022220000222
222000022225000222
222002222002200222
222002222082200222
200000000222200222
200000006222200222
222222200000000002
222222200000000032
222222222222222222
