222222222222222222
200222200002222222
200222200002222222
200220000222200002
200220040222200002
200000000222200222
200000000222200222
222222200000000222
222222208000700222
222000000222200222
222000000222200222
222002200222200222
222002206222250222
222002200220000002
222002200220000002
222002200222222002
222002200222222032
222222222222222222
