222222222222222222
200222222220022222
200222222220022222
200000000220000002
200000000220000502
222002222220022222
222002222220622222
222002222220000002
222002222220008002
222000000000022222
222000700000022222
222222222220000222
222222222220000222
200222222220022222
200222222220022222
200000000000000002
240000000000000032
222222222222222222
