222222222222222222
200002222220022002
200002222220022002
222000000000022222
222000000000022222
222220022222222002
222225022222222402
200000000002222002
200000006002222002
222002222222222002
222002222222222002
222002222220022002
222002222220022002
200000000000022002
200000800070022002
222222222220000002
222222222220000032
222222222222222222
