222222222222222222
200222200000022222
200222200000022222
200222222220022002
200222222220022402
200000022220000002
200000022220000002
222220000222200222
222220600222208222
200220000222200222
200220007222200222
222000000222200222
222000000222200222
222002200000000222
222002200000000222
222002222222200002
222002222222250032
222222222222222222
