222222222222222222
200000000000022222
200000000000022222
222002222220000002
222402222220000002
222000022222222002
222000022222222002
222222222000000002
222222222000600002
200002222002222222
200002222002222222
222002222002222222
222002222082222222
222000000000000002
222000000000750002
200222222222222002
200222222222222032
222222222222222222
