222222222222222222
200002222222200002
200002222222200002
222000000000022222
222000000000022222
222002222220022002
222002222220022402
222000022220000002
222000022220007002
222002222000022002
222002222080022002
222002222002222002
222002222002222002
222000022002222222
222500022062222222
200222222000000002
200222222000000032
222222222222222222
