222222222222222222
200002222222222222
200002222222222222
200222200000000002
250222200000000002
200000000222200222
200000007222200222
222220022220000222
222220022220800222
222000022220022222
222000622220022222
222222200000000002
222222200000000002
200000000222222002
200000040222222002
222222222002200002
222222222002200032
222222222222222222
