222222222222222222
200222222220000222
200222222220000222
200000000000000222
200000000000000222
222002222002200002
222002222502206002
222002222002222222
222002222002222222
200002222002200222
200002222002200222
200002222002200222
200002222002240222
222002222002200222
222002222072208222
222002222000000002
222002222000000032
222222222222222222
