222222222222222222
200222222220000222
200222222220000222
200220000000022222
200220000000022222
200002222002222002
200002222062222502
222000000002222002
222000008002222002
222002222002222002
222002222002222002
222002222002222002
222002222002222402
222002222222222002
222002222222222002
222000000000000002
222000700000000032
222222222222222222
