222222222222222222
200002222000000222
200002222004000222
222002222000000222
222002222000000222
222002222222200222
222002222222200222
222002200222200222
222002200222208222
222000000222200222
222000006222200222
222220000000000002
222220000000000002
200000022220022222
200000722225022222
222222200220000002
222222200220000032
222222222222222222
