222222222222222222
200000000000022222
200000000004022222
222000022222222002
222000022222222002
222220022222200002
222220822222200002
200000000000000222
200000000000007222
222222200222200222
222222200222200222
222000000222200222
222000000222206222
222002200222200222
222002200222200222
200222200222200002
200222200222250032
222222222222222222
