222222222222222222
200222222222222222
200222222222222222
200000000000000002
200000000000000002
200222222000000222
200222222000000222
200222200002222222
240222207002222222
222222200000000002
222222200080050002
222002222002200222
222002222002200222
222000000002200222
222000600002200222
222002222222200002
222002222222200032
222222222222222222
