222222222222222222
200222222220022222
200222222220022222
200220000000000002
200220000000000002
200220022222200222
200220822222206222
200000000222200222
200000007222200222
222000022220000222
222000022220040222
222220022220000222
222220022220000222
200000022220022222
200500022220022222
222220022220000002
222220022220000032
222222222222222222
