222222222222222222
200222222222200002
200222222222200002
200000000002222002
200000000002222002
222002222000000002
222002222080000002
222002200222200002
222002206222200002
222002222222200002
222002222222250002
222000000002222222
222000000002222222
222002222002222222
222402222072222222
222002222000000002
222002222000000032
222222222222222222
