222222222222222222
200002222000022222
200002222000022222
222000000002222002
222000000002222002
222002222000000002
222002222000700002
222000022222222222
222000022222222222
200220000222222222
200220006222222222
222220000220000002
222220000220000002
200000000000022002
200004000000822502
222222222222222002
222222222222222032
222222222222222222
