222222222222222222
200220022220000222
200220022220000222
200222200222200222
200222200222200222
200222200000000222
200222200000000222
200222200220000222
200222200220000222
200000000222200222
200000800222200222
222222222222200222
222222222222200222
222222222000000002
222222222070006002
200000000002222002
250000000402222032
222222222222222222
