222222222222222222
200222222222222002
200222222222222002
200000000000000222
200000000000000222
222002200222222222
222002200222222222
222002200220000002
222002208220050002
222222200000022222
222222200000022222
200000000220000222
200000000220700222
200222200222200222
200222200222206222
200222200222200002
240222200222200032
222222222222222222
