222222222222222222
200222222002200222
200222222402200222
200000022002200222
200000022002200222
222220000000000222
222220000000800222
222000022220000002
222000022220000002
200220000222222002
200220700222222002
222222200222222002
222222200222222002
200000000000022002
200005000000622002
222222222222222002
222222222222222032
222222222222222222
