222222222222222222
200222222222200222
200222222222250222
200000000002200222
200000000002200222
200002222000000222
200002222000007222
222000022222222222
222000022222222222
222220022222222002
222220022222222002
200220022000000002
200220022400600002
200000000000022222
200000008000022222
222222222220000002
222222222220000032
222222222222222222
