222222222222222222
200222222222222002
200222222222222002
200000000000022002
200000000000022002
222220022002222002
222220022002222002
222000022000000002
222400022000000002
222002222220022222
222002222220022222
222002200000022222
222002206000722222
200002200220000002
250002200220008002
222222200222222002
222222200222222032
222222222222222222
