222222222222222222
200222222222222222
200222222222222222
200000000000000002
200000050000000002
222000000222222002
222000006222222002
222002200220000002
222002200220040002
222002222220000222
222002222220007222
222002222222200222
222002222222200222
222000000000000002
222000008000000002
200222222222222002
200222222222222032
222222222222222222
