222222222222222222
200222200222200002
200222250222200002
200002200222200222
200002200222200222
222000000000000222
222000800000000222
222002222220022002
222002222220022002
222002222000022222
222002222070022222
222002222222222002
222002222222222002
200000000000000002
200000000400600002
200222222222222002
200222222222222032
222222222222222222
