222222222222222222
200222222000000222
200222222000000222
200000000002200222
200000000002250222
200220000002222222
200220040002222222
222220022002222002
222220822002222002
222000022000000002
222060022000000002
222002222002222222
222002222002222222
222002222002222222
222002222072222222
222002222000000002
222002222000000032
222222222222222222
