222222222222222222
200222222220000002
200222222220000002
200000000000000002
200000000000040002
222222222002222002
222222222062222002
222222222002222222
222222222002222222
200000000002200222
200000000002200222
222002222002200222
222002222002200222
222002222002200222
222002222082207222
222002222000000002
222002222000050032
222222222222222222
