222222222222222222
200000000002222222
200000000002222222
222002222000000002
222002222000008402
222002222222222002
222002222222222002
222002200222200002
222002207222200002
222000000222200002
222000000222200002
222002222000022222
222002222000622222
222002222222222222
222002222222222222
222000000000000002
222000000500000032
222222222222222222
