222222222222222222
200002222222222222
200502222222222222
222000000000000002
222000000000000002
222002222222222222
222002222222222222
222000000220000222
222000007224008222
222002200002200222
222002200002200222
222002222002200222
222002222062200222
200002222000000222
200002222000000222
222220022000000002
222220022000000032
222222222222222222
