222222222222222222
200002222222222222
200002222222222222
222000000000000002
222000000000000002
222002222222222002
222002222222222002
200002222220000002
250002222220000002
200222200222200222
200222200222200222
200222200000000222
200222208000600222
200222200220000002
200222200220007002
222220000222222002
222224000222222032
222222222222222222
