222222222222222222
200222222220000002
200222222220000002
200000000000022222
250000000000022222
200000022220022222
200000022220022222
222220022220000002
222220022220008402
200220022222222222
200220022222222222
222220022002222002
222220022002222002
200000000000000002
200000600000700002
222222222222222002
222222222222222032
222222222222222222
