222222222222222222
200002222000022222
200002222000022222
222002222002222002
222002222002222402
222002222002222002
222502222002222002
222002222002222002
222002222062222002
222000000000022002
222070000000022002
222002222220000002
222002222220800002
200002200220022222
200002200220022222
222220000220000002
222220000220000032
222222222222222222
