222222222222222222
200220000000000222
200225000000000222
200220022222200222
200220022222200222
200000022222200222
200000722222200222
222220000002222002
222220000062222002
200000022222200222
200000022222200222
222220022222200222
222220022222200222
222000000000000002
222000008000000402
222002222222222002
222002222222222032
222222222222222222
