222222222222222222
200002222000022222
200002222000022222
222002222002222002
222002222002222002
222002222000000002
222002222070000502
222000000002222222
222000008002222222
200002222222200222
200002222222240222
200222222000000222
200222222000000222
200000000002200002
200000006002200002
222222222002222002
222222222002222032
222222222222222222
