222222222222222222
200002200002222222
200002200002222222
222002222220000002
222002222220050002
222002200220022222
222002208220022222
200000000000022222
200000000060022222
200220022220000002
200220022220000002
222220022220022222
222220722220022222
222000022220022222
222400022220022222
222002222000000002
222002222000000032
222222222222222222
