222222222222222222
200222200220000222
200222200220040222
200000022222200222
200000022222200222
222220000002200222
222220007002200222
222222222000000222
222222222000000222
200002222222200222
200002222222200222
222002200222200222
222002208222200222
222000000000000222
222000000060000222
222002222000000002
222002222500000032
222222222222222222
