222222222222222222
200000000222200222
200000000222250222
222002222222200222
222002222222200222
222002222000000002
222002222000800002
222002222002222002
222002222002222002
200000000002200002
200000000062200002
222222200222200222
222222200222200222
222222200222200222
222222207222200222
200000000222200002
200000000222240032
222222222222222222
