222222222222222222
200222222222222222
200222222222222222
200220000000000002
200220007000000002
200000022220022222
250000622220022222
222222222220000222
222222222220000222
200222200000022002
200222200000022002
222002200220022002
222002200220022002
222000000220022222
222000000220822222
200222222000000002
200222222400000032
222222222222222222
