222222222222222222
200002222000000222
200002222000000222
222002222222200222
222002222222200222
222000000222200222
222000000222208222
222222200222200222
222222200222200222
200220000000000002
200220000000700002
200000022220022222
200000622220022222
222220022220000222
222220022220040222
222000000222200002
222500000222200032
222222222222222222
