222222222222222222
200000000220022002
200000000220022002
222222200220022002
222222200220022002
200222200000022002
200222200500822002
222000000222222002
222000000222222002
222002200222200222
222002200222206222
222002200222200222
222002200222200222
222002200000000222
222002200074000222
222002222222200002
222002222222200032
222222222222222222
