222222222222222222
200002222222222222
200002222222222222
222000000000000002
222000000000000002
222002222002222002
222002222002222002
222002222000022222
222002222070022222
222002222220000002
222002222220006002
200002200000022222
200002200080022222
200222200222222222
200222200222222222
200222200000000002
250222200400000032
222222222222222222
