222222222222222222
200222222222222222
200222222222222222
200000000000000002
200000000000050002
222222222002222222
222222222062222222
222222200000022222
222222207000022222
200000000222222002
200004000222222002
200220000222222002
200220008222222002
200222200000022002
200222200000022002
200220022220000002
200220022220000032
222222222222222222
