222222222222222222
200222200000022222
200222200400022222
200222200222222002
200222200222222002
200000000000000002
200000006000000002
222222222222200222
222222222222208222
222222222222200222
222222222222200222
200000000000000002
200000007000000002
222222200222222002
222222200222222002
222000000220022002
222005000220022032
222222222222222222
