222222222222222222
200002222222200222
200002222222200222
222002200002200222
222502200002200222
222000000000000222
222000000000000222
222002222222200222
222002222222200222
222002222002200002
222002222002208002
222000000222222002
222000006222222002
222000022220000002
222000722220000002
222000000222222002
222004000222222032
222222222222222222
