222222222222222222
200000022220000222
200000022220000222
222220022222200222
222225022222200222
222220022000000222
222220022000000222
200000000002200222
200000800002206222
222220022222200222
222220022222200222
222000022222200002
222000022222200402
222000000002222002
222000700002222002
200002222002222002
200002222002222032
222222222222222222
