222222222222222222
200222200000000222
200222200000000222
200000000222200222
200000000222200222
200002200222200222
250002200222200222
222222200222200222
222222200222206222
222222200222222222
222222200222222222
200000000000000002
200000000070008002
222002222222222002
222002222222222002
222000000002222002
222004000002222032
222222222222222222
