222222222222222222
200222222222222002
200222222222222002
200000000000000222
250000000000000222
222220022220022222
222220622220722222
222220022220022002
222220022220022002
200000022220022002
200000022220822002
200222222220000002
200222222220000002
200222200222222002
200222240222222002
200000000222200002
200000000222200032
222222222222222222
