222222222222222222
200002222000000222
200002222000000222
222002222002200222
222002222002200222
222000000002200002
222000007002200002
222002222002222222
222002222082222222
222002222000000222
222002222004000222
222002200002222222
222002206002222222
222002200222222002
222502200222222002
200222200000000002
200222200000000032
222222222222222222
