222222222222222222
200000000000000002
200000000000040002
222002222222222002
222002222222222002
222002200002222002
222002208002222002
222002222002222222
222002222002222222
222002222000000002
222002222005000002
222002222002222002
222002222062222072
222002222002222002
222002222002222002
222000000002222002
222000000002222032
222222222222222222
