222222222222222222
200222222222200222
200222222222250222
200220000000000222
200220000000000222
200000022222200222
200000722222200222
222220022220000222
222220022220000222
200220022222200222
200220022222200222
200000022002200222
200000022002208222
222220000002200002
222220006002240002
200002222002222002
200002222002222032
222222222222222222
