222222222222222222
200222222220022222
200222222220022222
200000000220000002
200000000224000002
200222222222200222
200222222222208222
200002222000000222
200002222000000222
200220022220022222
200220022220622222
200222200220022002
200222200220022002
200000000000000002
200000000000700502
222222222222222002
222222222222222032
222222222222222222
