222222222222222222
200000000000000222
200000000000000222
200222200222200222
200222200222200222
200222200222200222
200222200222250222
222222200002222222
222222200002222222
222002222000022002
222002222000822002
222002222220000002
222062222220007002
222000000000000002
222000000000000002
222002222222222002
222402222222222032
222222222222222222
