222222222222222222
200002222002222222
200002222402222222
222002200002200002
222002200002200002
222002200002222002
222002200002222002
222002200222222002
222002200222222002
222000000000000002
222000000000850002
222002200222222222
222002200222222222
222002200000000222
222002207000600222
222002222222200002
222002222222200032
222222222222222222
