222222222222222222
200222200000000222
200222200000000222
200000000222200222
200000000222200222
200222200222222222
200222206222222222
200222200000000002
200222200000000002
222222222002222222
222222222002222222
222000000002222222
222000008002222222
222002222000000002
222002222000007502
222000000222222002
222000040222222032
222222222222222222
