222222222222222222
200002222222200002
200502222222200002
222002200000022222
222002200000022222
222002222220000002
222002222220000002
222002222220022222
222002222220022222
200000000000000002
200000600000007002
222002222002222002
222002222402222002
222002222002222002
222002222082222002
222002200222200002
222002200222200032
222222222222222222
