222222222222222222
200220022000022002
200220022000022002
200220022002222222
200220022002222222
200222200000000002
250222200000700002
200000000222222222
200000000222222222
222220022222222222
222220022222222222
222220022000000002
222220822000006402
200000000002222002
200000000002222002
222222222222200002
222222222222200032
222222222222222222
