222222222222222222
200222200000022002
200222200000022002
200222200222222002
200222200222222002
200002200222200222
200002250222240222
222002200222200222
222002207222208222
222002200222200222
222002200222200222
222002200000000222
222002200060000222
222002222222200222
222002222222200222
222000000000000002
222000000000000032
222222222222222222
