222222222222222222
200222200002222002
200222200002222002
200000000000000222
200000000000000222
222220000222222222
222220007222222222
222000000002222002
222000000062222002
222002222002222002
222002222002222402
222002222000000002
222002222080000002
222002222002222002
222002222002222002
222002222002222002
222502222002222032
222222222222222222
