222222222222222222
200002222000022222
200002222000022222
200222200222200002
200222200222200402
200000000222200222
200000006222200222
222222200000000222
222222200000000222
222000000222200222
222005000222200222
222220022222200222
222220022222208222
200000022000000002
200000022000700002
222222222002222002
222222222002222032
222222222222222222
