222222222222222222
200222222000000222
200222222000050222
200000000002200222
200000000002200222
222002222222200222
222002222222200222
222002222000000222
222002222000000222
200000022220022222
200000022220622222
222222200220000002
222222207220040002
222000000000022002
222000000080022002
200222222222222002
200222222222222032
222222222222222222
