222222222222222222
200000000222222002
200000000222222002
222002200000000222
222002200000000222
222002200222200222
222502200222200222
222002200222222002
222002206222222002
222002200000000222
222002200070000222
222002200222222222
222002200222222222
200002200000000002
200002200080000402
222220022222222002
222220022222222032
222222222222222222
