222222222222222222
200002222000022002
200002222400022002
222002222002222222
222002222002222222
222002200002200002
222002200002207002
222002222000000222
222002222000800222
222002222000000222
222002222500000222
222002222002200222
222002222062200222
222002222222200222
222002222222200222
222000000000000002
222000000000000032
222222222222222222
