222222222222222222
200222222222222002
200222222222222002
200000000000000222
200000000000000222
200222200222200222
200222200222200222
200220000222200222
200220800222200222
200002222222222002
200402222222222002
200222222000022002
200222222000022002
200000000002222222
200000600072222222
222222222000000002
222222222500000032
222222222222222222
