222222222222222222
200000022220000002
200000022220050002
222002222220022222
222002222220022222
222000000000000222
222000000000000222
222002222222200222
222002222222207222
200002222000000222
240002222000800222
200222222002222222
200222222002222222
200220000000000002
200220000000600002
200222222222222002
200222222222222032
222222222222222222
