222222222222222222
200000000002222002
200000000002222002
222222222002200222
222222222002200222
222000000000000222
222000000060000222
222002222222200222
222002222222200222
200002222222200222
240002222222208222
200220000000000222
200220700000050222
200220022222200222
200220022222200222
222220022220000002
222220022220000032
222222222222222222
