222222222222222222
200222222222200222
200222222222250222
200000000002200222
200000000002200222
200222222000000222
200222222000006222
200222200002200222
200222200002200222
222222200222222222
222222207222222222
222000000000000002
222400000080000002
200222200222222002
200222200222222002
200220000220022002
200220000220022032
222222222222222222
