222222222222222222
200002222222222222
200002222222222222
200222200000000002
200222200000000002
200000000002222002
200000600002222502
222002222002200222
222002222002200222
222002222002200222
222002222072200222
222002222002222002
222002222002222002
222002222002222002
222002222082222002
200002222000000002
240002222000000032
222222222222222222
