222222222222222222
200222222222222222
200222222222222222
200000000000000002
200000000000000002
200222222002222222
200222222002222222
200222200000022002
200222250080022002
200220022220022222
200220622220022222
200222222000022002
200222222000722402
200000022220022002
200000022220022002
222220022220000002
222220022220000032
222222222222222222
