222222222222222222
200222222222222002
200222222222222002
200000000000000222
200000000000000222
222002222222200222
222002222222200222
222002222002200222
222002222002200222
200000000222200222
200000700222206222
200222200220000002
200222200220000502
200220000220022002
200224008220022002
200222222220022002
200222222220022032
222222222222222222
