222222222222222222
200000022002200222
200000022002250222
222002222222200222
222002222222200222
222002200002200222
222002200082207222
200000000222200222
200000000222200222
222220000000000002
222220000060000002
222000022002222222
222400022002222222
222002222002222222
222002222002222222
222002222000000002
222002222000000032
222222222222222222
