222222222222222222
200000000222200222
200000000222240222
222222200000000222
222222200000000222
222222200222200002
222222200222200002
200000000002222002
200000600002222002
222222200220000222
222222200220700222
222000000222222222
222000000222222222
222002200000000002
222002200085000002
222002222222222002
222002222222222032
222222222222222222
