222222222222222222
200000000000000002
200000000000040002
200222200220022002
200222250220022002
222222200222222222
222222200222222222
222002200222200222
222002207222200222
222002200000000222
222002200060000222
222002200222200222
222002200222200222
222000000222200222
222000008222200222
222002222220000002
222002222220000032
222222222222222222
