222222222222222222
200222222222222222
200222222222222222
200000000000000002
200000000000000002
222222200002222222
222222200002222222
222002222000000222
222502222080000222
222002222000022222
222002222000622222
222002222002222002
222002222002222002
222000000000000002
222000000000007002
200002222002222002
240002222002222032
222222222222222222
