222222222222222222
200002222002222002
200002222002222002
222002200002222002
222002200002222002
222002200222222002
222002207222222002
222002200220022002
222502200220022002
222000000000000002
222000000000006002
222002222222222002
222002222222222002
222002222220000002
222002222220800002
222000000222222002
222004000222222032
222222222222222222
