222222222222222222
200000000002200002
200000050002200002
222000022002222002
222000022002222002
222002222222200222
222002222222206222
222000000220000222
222000000220000222
222002222220000222
222082222220000222
222002222222200222
222002222222200222
222000000000000002
222000000070000002
222002222222222002
222402222222222032
222222222222222222
