222222222222222222
200222222222222002
200222222222222002
200000000000000222
200000000000000222
200222222222200222
200222222222200222
200222200000000222
200222250000008222
200222222220000002
200222222220000002
200000022220022222
200000022220622222
222002222000000222
222402222000007222
222000022222200002
222000022222200032
222222222222222222
