222222222222222222
200000000002222222
200000000402222222
222002222002200002
222002222002200002
222002222002222002
222002222002222002
222002222222200002
222002222222200002
222000000002200222
222000600002200222
222002222222200222
222002222222200222
222000000000000222
222000700000850222
200222222222200002
200222222222200032
222222222222222222
