222222222222222222
200222222222222002
200222222222222002
200000000000000222
200000000005000222
200222222222200222
200222222222200222
200002222222200002
200002222222200002
222002200002222002
222002200072222002
222000000222200222
222000800222200222
200002200222200222
240002206222200222
222222200000000002
222222200000000032
222222222222222222
