222222222222222222
200222222222200222
200222222222200222
200000000000000222
200000000000050222
222002222220022222
222002222220022222
222002222222200002
222002222222208002
222002200000000222
222002206000000222
200002222002222222
200002222072222222
200000000000022002
200000000000022002
222222222220000002
222222222220040032
222222222222222222
