222222222222222222
200000022222222002
200000022222222002
222220000000000222
222220000000000222
222000000222200222
222005000222208222
222222222220000222
222222222220000222
200000000000000222
200000600000007222
222222200222222222
222222200222222222
200000000000000002
200004000000000002
222222222222222002
222222222222222032
222222222222222222
