222222222222222222
200000000220000222
200000000224000222
200222200222200222
200222200222200222
200222200000000222
200222207000000222
200222200220000002
200222200220800002
200222200222200222
250222200222200222
200222200222200222
200222200222200222
200222200222200222
200222200222206222
222220000222200002
222220000222200032
222222222222222222
