222222222222222222
200222222222222002
200222222222222002
200000000000000222
200000000000000222
200222222222200222
200222222222200222
200220022000000002
240220022080000002
222222200002222222
222222207002222222
222000000222200222
222000000222200222
200002200222200222
250002206222200222
222222200000000002
222222200000000032
222222222222222222
