222222222222222222
200222222002200002
200222222002200402
200000000222200222
200000000222200222
222222200222200222
222222207222200222
222002200222200222
222002250222200222
200000000222200222
200000000222208222
200222222222200222
200222222222200222
200222200000000002
200222206000000002
200000000222222002
200000000222222032
222222222222222222
