222222222222222222
200222222222222002
200222222222222002
200000000000000222
200000000000000222
222220022222200222
222220022222240222
222000022220000002
222000022220000002
222002222002222222
222002222072222222
200000000222222222
200000006222222222
200002200000000002
200002200000008002
222222200002222002
222222200502222032
222222222222222222
