222222222222222222
200000000000000002
200000000000040002
222222222002200002
222222222002207002
222222222002222222
222222222002222222
200000000002222222
250000000002222222
200222222000000002
200222222000008002
222222222002222002
222222222002222002
222000000002222002
222000600002222002
222002222002222002
222002222002222032
222222222222222222
