222222222222222222
200222200220000002
200222240220000002
200222200222222222
200222200222222222
200222200000000002
200222200075008002
200002200222222222
200002200222222222
222000000002222222
222000006002222222
222002222222200002
222002222222200002
222002222222222002
222002222222222002
222000000000000002
222000000000000032
222222222222222222
