222222222222222222
200222222222222222
200222222222222222
200000000000000002
250000000000000002
222220022002222222
222220022002222222
200220022000022002
200220022000722002
200220022220000222
200220022220000222
222000022222200222
222000822222206222
222000022000000222
222400022000000222
200222200222200002
200222200222200032
222222222222222222
