222222222222222222
200000000000000002
200000000000000002
222002222222222002
222002222222222002
222002222222222222
222002222222222222
200000000000000222
200000800000000222
222222200222200222
222222200222200222
222000000222200222
222000000222207222
222002200002200002
222002206402200002
222002222002222002
222502222002222032
222222222222222222
