222222222222222222
200000000220022002
200000000220022002
222002222220022222
222002222220022222
222002222220000002
222002222220050002
222002200000000222
222002200000600222
222000000222200222
222000000222207222
222002200222200222
222002208222200222
222002222220000222
222002222220040222
222002200220000002
222002200220000032
222222222222222222
