222222222222222222
200222222222200222
200222222222200222
200000000000000222
200000000000000222
222222200220022222
222222200220022222
222000000222222002
222000700222222002
222002222222222002
222002222222222502
222002200000022002
222002200080022002
222000000000000002
222000000000600002
222002222002222002
222402222002222032
222222222222222222
