222222222222222222
200002222222222222
200002222222222222
200000000000000002
200000000000000002
222002200220022002
222002200220022002
222002222220022222
222002222220022222
222002222220022002
222002222220622002
222002200222200002
222002200222207002
222000000222222222
222000800222222222
200222200000000002
200222240000050032
222222222222222222
