222222222222222222222222222222
200000022220022000000002222002
200000022220022000000002222002
222002200002222002222222222002
222002200002222002222222222002
222002200222222000022220000002
222002200222222000022220700002
222002200220022220022220022222
222002200220022225022220022222
200000000220022000000000022002
240000000220622000000000022002
222222200000000002222002222002
222222200000000002222002222002
222000000220022222200000000222
222000000220022222200000000222
222002222222200220000000000222
222002222222200220000000000222
222002222002222222222220022222
222002222002222222222220022222
222000000000000002222000000002
222000008000000002222000000002
222002222000022002222222222002
222002222000022002222222222002
222002222002222222200222222002
222002222002222222200222222002
200000022000000222200000000002
200000022000000222200000000002
222222222000000002222222222002
222222222000000002222222222032
222222222222222222222222222222
