222222222222222222222222222222
200000000002200222200222200222
200000000002200222200222200222
222222222002222002200220000222
222222222002222002200220000222
222222222000022002200222200222
222222222000022002207222200222
200000022220000000000222200222
200000022220000000000222200222
222220000000000222200222200222
222220000000000222200222200222
200222200002222220000222200222
200222200002222224000222200222
222000000000022222200002200002
222000000000022222200002200002
222000022002222002222002222002
222000022002222002222002222002
222002222222200000000000000002
222002222222200000000000600002
222000000222222000022002222002
222000000222222000022002222002
222002222220022002222000022222
222002222220022082222000022222
200000022000000002222220022222
200000022000000002222220022222
200222222002222222200000000002
250222222002222222200000000002
200002222000022002200222222002
200002222000022002200222222032
222222222222222222222222222222
