222222222222222222222222222222
200222200000022002222222222222
200222200000022002222222222222
200000000220022220000000000002
200000000220022220000000000002
200220022220022222222002222222
200220022220022222222002222222
222220022220022000000002222222
222220022220022000000002222222
222000022000000002222000000002
222000022000000002222000000002
222002200222222002222002222222
222002250222222002222002222222
222002200002222002222000000222
222002200002222062222000000222
222002222002200220022220000222
222002222002200220022220000222
222000000002222222200000022222
222000000002222222200000022222
200220000222200002200222222002
200220000222200002200222222002
222222200000022000000222222002
222222200000022000000222222082
200000000220022222200220000002
200000000220022222200220000002
222000022220022000000000022002
222000022220022070000000022002
222000000220022222222222222002
222000040220022222222222222032
222222222222222222222222222222
