222222222222222222222222222222
200222222222222002222002200222
200222222222222002222002200222
200000000000000002200222200222
200000000000600002200222200222
222222222222222002200000000222
222222222222222002200004000222
222222222002200000000222222222
222222222002200000000222222222
200000000002222220000002222002
200000800002222220000002222002
222220000002222220022222200002
222220000002222220022222200002
222000000002200000022002200222
222000000002200000022002200222
200222200002222000000000000222
200222200002222000007000000222
222000000000000002200002200222
222000000000000002200002200222
222002200220000002222222200222
222002200220000002222222200222
222002222220022000022222200002
222002222220022000022222200502
222002222000022000000002222222
222002222000022000000002222222
222002222002222002222002222222
222002222002222002222002222222
222002222002200222200000000002
222002222002200222200000000032
222222222222222222222222222222
