222222222222222222222222222222
200000000002200222200000022002
200000000002200222200000022402
200220022002222000022222222002
200220022002222000022222222002
222220022222222002222000022002
222220022222222002222000022002
222220022220000000000002200002
222220022220050000000002200002
200000000222222220022002200222
200000000222222220022082200222
222220000222200000022002200222
222220000222200000022002200222
200220022220000220022000000002
200220022220000220022000000002
222000022220022220022222200002
222000022220022220022222200002
222002222220022220022002200222
222002222220022220022072206222
222002200000022000000002200222
222002200000022000000002200222
222002222220022002222222222002
222002222220022002222222222002
222002222220022002222220022002
222002222220022002222220022002
222000000220022000000000022222
222000000220022000000000022222
200222200000022222222220000002
200222200000022222222220000032
222222222222222222222222222222
