222222222222222222222222222222
200000022220000000000002200002
200000022220000000000002200002
222002222222222220022222222222
222002222222222220022222222222
222000000002200000022220000002
222070000002200000022220000002
222222222000000222222000022222
222222222060008222222000022222
200220022002200000022220000002
200220022002200000022220000002
200222200002222220022220022222
200222200002222220022220022222
200222200222200000022220000222
200222200222200000022220000222
200002200220022222222220000222
200002200220022222222220040222
222000000000022222200000022222
222000000000022222200000022222
222002222220000002200000000002
222002222220000002200000000002
200220022220022000000222222002
200220022220022000000222222002
222222200000022222200222222222
222222200000022222200222222222
200000000222222000000000000222
200000000222222000000000000222
222222200002222002222222200002
222222250002222002222222200032
222222222222222222222222222222
