222222222222222222222222222222
200222222222222222222222222222
200222222222222222222222222222
200000000000000000000000000002
200000000000000000000000000002
200220022222200222222220000002
200220822222200222222220000002
200220000222200000022220022222
200220000222200000022220022222
200220000222200220022220000222
200220000222200220022220000222
200220022220000220000002200222
200220022220000220000002200222
200222222222222222200222200002
200222222222222222200222200002
200222200000022000000002222002
200222200000022000050002222002
200000000002222222222220022002
200000000002222222222220022002
222220000222200222200002200222
222220000222200222200002200222
222222200000000222200002222222
222222200000600222200002222222
200000000222200222222000000002
200000040222200222222000000002
200222200000000000000002222002
200222200000007000000002222002
200220022222222222222222200002
200220022222222222222222200032
222222222222222222222222222222
