222222222222222222222222222222
200222200222200222222220022002
200222200222200222222220022002
200000000220000220000000022222
200000000220000220000000022222
222222200000022220022002222002
222222200070022220022002222002
222002222000000000022002222002
222002222000000000022502222002
222002222222200222222002222002
222002222222200222222002222002
222002200222200002222002222002
222002200222200002222002222002
222000000000000002200222200002
222000000000000002200222200002
222002200222222220022220000222
222002200222222220022220000222
222002222222222000022222200222
222002222222222000022222200222
222002222000000002200000000002
222002222000000002200000006002
222002222222222002222220000002
222002222222222002222220000402
222000000002222002200220022002
222000000002222002200220022002
222002200222200002222000022002
222002200222200002222000022002
200222200000000000000002222002
200222200000008000000002222032
222222222222222222222222222222
