222222222222222222222222222222
200000022222222220022222200222
200500022222222220022222200222
222002222000000000022002200222
222002222000000000022002200222
222000000222222220000002200222
222000000222222220000002200222
222002200222222222200000000222
222002200222222222200000000222
200222200000000000000222200222
200222200000000000000222200222
200222222220022220022222200222
200222222220022220022222240222
222000000000000220000002222222
222000006000000220000002222222
222002222002222000022222200002
222002222002222000022222200002
222000022222200000000000000222
222000022222200000000000000222
222000022222200002222222200222
222000022222200002222222200222
222002222002200002222222200222
222002222002200002222222208222
222222200000000000000002200222
222222200000000000000002200222
200002200002222002200222200222
200002200002222002200222200222
200000000002222002222002200002
200000000002222072222002200032
222222222222222222222222222222
