222222222222222222222222222222
200000022222222002200220022002
200000022222222002200220022002
200222222000000002222220022222
200222222000000002222220022222
200000022002222222200220022002
200000022002222222200220022002
222000000002222220000220000002
222000000002222220000220000002
222222200222200222200222200222
222222200222200222200222207222
200220000002200000000222200222
200220000502200000000222200222
200220022222200222200000000002
200220022222200222200000000402
200220000222200000022222222002
200220000222200000022222222002
200002200222200222222222222222
200002200222200222222222222222
222002200000000000000000000222
222002200000000000000000000222
222002222002222220022222200222
222082222002222220022222200222
222000000000022220000002200002
222000000060022220000002200002
222002222002222220000002222002
222002222002222220000002222002
222002222000000222222002222002
222002222000000222222002222032
222222222222222222222222222222
