222222222222222222222222222222
200222222222222002222000000222
200222222222222002222000000222
200000000000000220000002200222
200000000000000220000002200222
222002222000022220022002200002
222002222000022220022002200402
222002222000022220022000022002
222002222000722220022000022002
222000022220022220022220022222
222000022220022220022220022222
222000000222222220000222200222
222000000222222220000222200222
222222200222200222200222222002
222222200222200222200222222002
200000000002200222200000000002
200000000002200222200000050002
222222200000000002222002222002
222222200000000002222002222002
222220000000000000000000022222
222220000000000000000000022222
200000000222222222222002222002
200000008222222222222002222002
222220022222222220022000000222
222220622222222220022000000222
200000000000000002222002200222
200000000000000002222002200222
222222222222222220022002200002
222222222222222220022002200032
222222222222222222222222222222
