222222222222222222222222222222
200002222220022222200000000002
200002222220022222200000000002
222000000220000002222220022222
222000000220000072222220022222
222002200222222002222220000222
222002200222222002222220000222
222002222220022000000222200002
222002222220022000000222200002
222002222002222000022222222002
222002222002222000022222222002
222002222002222002222000000002
222002222002222002222000600002
222000000000000000000002222222
222000050000000000000002222222
222002222222222000022002222222
222002222222222080022002222222
200002222220000222222002200002
200002222220000222222002200002
222222200220022222222002200222
222222200220022222222002200222
222220000000022000022000000222
222220000000022000022000000222
200000022220000002200000022222
200000022220000002200000022222
222000000002200222200220000002
222000000002200222200220000002
222002222002200000000222222002
222002222402200000000222222032
222222222222222222222222222222
