222222222222222222222222222222
200222222222222000000000000002
200222222222222000000000000002
200000000000000002222002222002
200060000070000002222002222002
200222222002200002222002222002
200222222002200002222002222002
200222222002222222222002222002
200222222002222222222002222002
222220022222222220022002222002
222225022222222220022002222402
200220022220000000022002222002
200220022220000000022002222002
200220000000000222222000022222
200220000000000222222000022222
222220022222200222200000000222
222220022222200222200000000222
200000022222200220022222200222
200000022222200220022222200222
222222222000000000022002200222
222222222000000000022002200222
200220022222222220022002200002
200220022222222220022002200002
222220022220000000022002200222
222220022220000000022002200222
200000000220000220000222200222
200000000220000220008222200222
222222200000000222200000000002
222222200000000222200000000032
222222222222222222222222222222
