222222222222222222222222222222
200000000222200000022000022002
200000000222200000022000022002
222002222220000220022222222002
222002222220000220022222222002
222002200220022220022000000002
222002200220022220022000000002
222002222000022220000002200222
222002222000022220000072250222
222000000002222222222222200222
222000000002222222222222200222
200002222000000002200000022222
200002222000000002200000022222
222222200002222002222222222002
222222200002222002222222222002
222222222222200000000000000002
222222222222200000000000000002
200000022222200222200220022222
200000622222208222200220022222
222220000000000220022220000002
222220000000000220022220000002
200222200222200220000220022222
200222200222200220000220022222
222002200222200002200220022222
222002200222200002200220022222
222000000222222002200220022002
222000000222222002200220022002
200222222220000002222000000002
200222222224000002222000000032
222222222222222222222222222222
