222222222222222222222222222222
200000022222222000022220000002
200000022222222000022220000002
200000000000000002222000022002
200000050000000002222000722002
200222222222200002222002222002
200222222222200082222002222002
222220000002200222200002222002
222220000002200222200002222002
222220022222200222200222222002
222220622222200222200222222002
200000022222200222222220000002
200000022222200222222220000002
222220000000000000000000022222
222220000000000000000000022222
200222200220022222200220000222
200222200220022222200220000222
200222222220022222200222200002
200222222220022222200222200002
200220022220000002222222200002
200220022220000002222222200002
200000000000000222200000000222
200000000000000222200000000222
222220022222200222200222200222
222220022222200222200222200222
222220022220000222200222200222
222220022220000222240222200222
200000000222222220000222200002
200000000222222220000222200032
222222222222222222222222222222
