222222222222222222222222222222
200000000002222000000002222222
200000040002222000000002222222
222220022000000002200222200002
222220022000000002200222200002
200000022220022222200222222002
200000022220022222200222222502
222222222000022222200000022002
222222222000022222200000022002
222002222002222000000220000002
222002222002222000000220000002
222000000000022222222220022222
222000006000022222222220022222
200222222000000222200220022222
200222222000700222200220022222
222220000002222002200220000002
222220000002222002200220000002
200222200222200222200220022222
200222200222200222200220022222
200000000220000222200000000222
200000000220000222200000000222
222002222000022222222002222222
222002222000022222222002222222
222002222220022000000002222002
222002222220022000000002222002
200002200000000000022000000002
200002200080000000022000000002
222220022222222222222002222002
222220022222222222222002222032
222222222222222222222222222222
