222222222222222222222222222222
200222222222222222222222200222
200222222222222222222222200222
200000000000000000000002200222
200080000000000000000002200222
222220000222222222222000000222
222220000222222222222000000222
200000022222200220000002200222
200000022222200220000002200222
200222222000022220022222222002
200222222000022220022222222002
200000000002200220000000000222
200000000002200220000005000222
200002200002222000022222200222
200062200002222000022222200222
200002222002222000022222222002
200002222002222000022222222002
222002222002200002222000022002
222002222002200002222000022002
222002200002200222222220022002
222002200072200222222220022002
222220000220000000000000000222
222220000220000000000000000222
200000022222222002222222222222
240000022222222002222222222222
200220000002222000000000000002
200220000002222000000000000002
200222222002200222222222222002
200222222002200222222222222032
222222222222222222222222222222
