222222222222222222222222222222
200002200220022220000220022002
200002200220022220000220022002
222002222220022220022222222002
222002222220022220022222222002
222000000000022220000000000002
222000000000022220000000000002
222000022220000220022222222222
222000022220000220022222222222
222000022220022220022222222222
222000022220022220022222222222
222220000222200220000000000002
222220000222200220000000000402
200000000222200000022222222222
200000000222200000022222222222
222220000000000220022222222002
222220008000000220022222222072
222222222000022220000000000222
222222222000022220000000000222
200000000000000222200002200222
200000000000600222200002200222
200220022220022222222222200002
200225022220022222222222200002
200222222220022000022002222222
200222222220022000022002222222
200220000000000000000002222222
200220000000000000000002222222
200222222222222222200000000002
200222222222222222200000000032
222222222222222222222222222222
