222222222222222222222222222222
200002222000000222200220022222
200002222000000222200220022222
222002222222200222200222200002
222002222222200222250222200002
222000000220000222200222200222
222000000220000222200222200222
200222200000022220000222200222
200222200084022220000222200222
200220000000000000000000000222
200220000000000000000000000222
200222222222200002200220022222
200222222222200002200220022222
222002200222222222200220000002
222002200222222222200220000002
222002222000022222200222222222
222002222000022222200222222222
222002222000000000000002222222
222002222000000060000002222222
222002200002222220022002200002
222002200002222220022002200002
222000000220000000022002200222
222000000220000070022002200222
222002200222222002222000000222
222002200222222002222000000222
222002200222200002200000000002
222002200222200002200000000002
222002200002200222200222222002
222002200002200222200222222032
222222222222222222222222222222
