222222222222222222222222222222
200000000000000000022220022222
200000000000000000022225022222
222222222222200222222220022002
222222222222200222222220022002
222222200222200000000000022002
222222200222200000000000022002
200000000222200222200222222002
200000000222200222200222222002
222222200000000222200222222002
222222200000000222200222222002
222220000000022222200000000002
222220000060022222200000000002
200000022222222002222002222222
200000022222222002222072222222
222220000002200002222000000222
222220000002200002222000000222
222000000222200002222002222002
222000000222200002222002222002
200222200002200220022000000222
200222200002200220022000000222
222220000222200222222222200222
222220000222200222222222200222
200222200000000000000222200222
200222200000000000800222200222
200000000220022002222222200222
200000000220022002222222200222
222222222220022000000002200002
222222222220022004000002200032
222222222222222222222222222222
