222222222222222222222222222222
200000022222222222222222222002
200000022222222222222222222002
222220022000000000000000022002
222220022000000000000000022002
200000000002222222200000000002
200000000002222222200000000002
222222200002222000000220022222
222222200002222500000220022222
200222222002200002222220000222
200222222002200082222220000222
222000022002222000022000000222
222000022002222000022070000222
222000022002222222222222200222
222000022002222222222222200222
200220000002200002200002222222
200220000002200002200002222222
222222200000000000000000000002
222222200000000000000000000002
200000000222222220000002222002
200000000222222220000002222002
222222222220022000022220022222
222222222220022000022220022222
222222222220022002222222200222
222222222220022002222222200222
200000000000000000000002200222
200000000000000000000002200222
222222222222222222222000000002
222222222222222222222000640032
222222222222222222222222222222
