222222222222222222222222222222
200000022220022220022220022002
200000022220022220022220022002
200220022220022220022000022222
200220022220022220022000022222
200220022220022220000002222002
200220022220022220000002222002
222220022220022222200000000002
222220022220022222200000000002
222000022220000000000222222222
222000022220000000000222222222
222002222220000222222220022222
222002222220000222222220022222
222002200000022222222220000002
222002200000022222222220000502
222002222220000000000220022222
222002222220000000000220022222
222002222000000002200000022222
222002222060000002200000022222
200000000002222002200000000002
200000008002222002200000000002
200222222000022000022222200002
200222222000022000022222200002
200222222000022220000222200222
200222222000022220000222200222
200220000000022000022222200222
200220700000022000022222200222
222220022222200222222000000002
222220022222200222222000040032
222222222222222222222222222222
