222222222222222222222222222222
200222222002222220022220000222
200222222002222220022220000222
200220022002200220022222200222
200220022002200220822222200222
200220000000000000000000000222
200220000000000000000000000222
200222200222222222222002222002
200222200222222222222002222002
200002200222200222200000022002
200002250222200222200000022002
222000000000000222200220022222
222000000000000222200220022222
222000022222222220000220022002
222000022222222220000220022002
222220022222200222222000000002
222220022222200222222000000002
200000000000000222200000022002
200000000000000222200000022002
222220022002200222200220022222
222220022402200222200220022222
222220022002200222200220022222
222220022002200222200220022222
200000022002200002222220022002
200000022002200002222220022002
200222222002222000022000000002
200222222002222060022000700002
200002222002222000022222222002
200002222002222000022222222032
222222222222222222222222222222
