222222222222222222222222222222
200220000000022222200002222222
200220000000022222200002222222
200222222220000002222002200002
200222222220000002222002200002
200000000222222002222000000002
200000000222222002222000000002
222222200002222002200220022222
222222200002222002200220022222
222220022000000002200220022002
222225022000006002200220022002
200000022002222002222220022002
200000722002222002222220022002
200002222002222000000000022002
200002222002222000000000022002
222002222002222000022220022002
222002222002222000022220022002
222002222002222222222000000222
222002222002222222222000800222
200000000000000000000222200222
200000000000000000000222200222
200220000222222222222222200002
200220000222222222222222200002
222222200222222000000002222222
222222200222222000040002222222
222000000000000000022002222222
222000000000000000022002222222
200222222222222222222000000002
200222222222222222222000000032
222222222222222222222222222222
