222222222222222222222222222222
200002222000022222222222222002
200002222000022222222222222002
200002222000022000000000000222
200002222000022000000000700222
200220022000000000022002200222
200220022000000000022002200222
200222222000022220022222200222
200222222000022220022222200222
200000022002222220022220000222
200000022002222220022220000222
200220000000000220022220022002
200220000000000220022224022002
222220000002222002222002222222
222220000002222002222002222222
222000022222222220022002200002
222000022222222220022002200002
222000000000000002222000000222
222000000060000002222000000222
222002222002222222222002200222
222002222002222222222002200222
222002222000000000000002222002
222082222000000000000002222002
222002222222222002222002200002
222002222222222002222002200002
200000000222200000022002222222
200000000222200005022002222222
222222200222200222222000000002
222222200222200222222000000032
222222222222222222222222222222
