222222222222222222222222222222
200222222222222220022222200222
200222222222222220022222200222
200000000000000220000002200222
200000000000000220000002200222
200222222222200002222000000222
200222222222200002222000000222
200002222000000000022222200222
200002222000000500022222200222
222222200222222000022222200222
222222200222222000022222200222
222000022222222002222000000222
222000022222222002222000000222
222000022000000002200002222222
222000022000000002200002222222
222000000002222222200222222002
222000000062222222200222222002
222000000002200220000000000002
222000000002200220000000000002
222000000002222220022220022002
222070000002222220022220022002
200002222220000000022220022002
200002222220000000022220822002
200000022220022222222220022002
200000022220022222222224022002
200000000000000000000220022002
200000000000000000000220022002
222222222222222222200222222002
222222222222222222200222222032
222222222222222222222222222222
