222222222222222222222222222222
200222200000000222222222222222
200222200000000222222222222222
200000022222222000000000000002
200000022222222000000004000082
200222222000000222200002222222
200222222000000222200002222222
200222222222200002200222200222
200222222222200002200222200222
200000000220000222200222200222
200500000220000222200222200222
222222200000022222200222200222
222222200000022222200222200222
200222200002222002200222200222
200222200002222002200222200222
200002200222222002200222200222
200002200222222002207222200222
200000000000000000000222200222
200000600000000000000222200222
222220000222222220000000000222
222220000222222220000000000222
222000000220000220022222200222
222000000220000220022222200222
200000022220000220022222222222
200000022220000220022222222222
200000000002222220000000000002
200000000002222220000000000002
200222222222200000022222222002
200222222222200000022222222032
222222222222222222222222222222
