222222222222222222222222222222
200002222002222222222222222222
200002222002222222222222222222
222000000220000000000000000002
222000000220000000000500000002
222002200222222222222222200002
222002200222222222222222200002
200002222222222222222222200222
200002222222222222222222200222
200222222000000000000002200222
200222222000600000000002200222
200220022222222002222002200222
200220022222222002222002207222
200220022000022002222000000002
240220022000022002222000000002
200220000000000000022220022222
200220000000000000022220022222
200222222002222002222000000002
200222222002222002222000000002
200002200222222002222002222002
200002200222222002222002222002
200000022220022002222222200002
200000022220022002222222200002
200000022000022002200222200222
200000022000022002208222200222
200220000000000000000002200222
200220000000000000000002200222
200222200222222220022222200002
200222200222222220022222200032
222222222222222222222222222222
