222222222222222222222222222222
200000022000000222222222222002
200000022000000222222222222002
222220022222222000000000022002
222220022222222000007000022002
222220000000000002222220000002
222220000000000002222220000002
200000022222222000000220022222
200000022222222000000220022222
222220022222222002222220000222
222220022222222002222220000222
222222222000000000022220000222
222222222000000060022220000222
200002222000022222222220022222
200002222000022222222220022222
222000022220000000000222222002
222000022220000000000222222002
222220000000022002200000022002
222220000000822002200000022002
200000000220022002222220022002
200000000220022002222220022002
200222222220022222222000000002
200222222220022222222000000002
222000022220022220000002222002
222000022220022220000502222002
222000022220022220022002222002
222400022220022220022002222002
222000000000000222222002222002
222000000000000222222002222032
222222222222222222222222222222
