222222222222222222222222222222
200222222000000000000002222222
200222222000000000000402222222
200000000002200222222000000002
200000000002200222222000000072
200002200222200002222222222222
200002200222200002222222222222
200222200002222000000222200002
200222200002222000000222200082
200220022222200220000222200222
200220022222200220000222200222
200222222222200222200000000222
200222222222200222200000000222
222220000000000220000222200222
222220000000000220000222200222
222220022222200000000002222002
222220022222200000050002222002
200000022222200222222002222222
200000022222200222222002222222
222220022002200000022222200002
222220022002200000022222200002
200220000002222220022222200222
200220000002222220022222200222
222002222002222000000000000222
222002222062222000000000000222
222000000002222002222222200002
222000000002222002222222200002
200222222002222000000002222002
200222222002222000000002222032
222222222222222222222222222222
