222222222222222222222222222222
200000000222200002222000022002
200000000222200002222000022002
222002222222222002222002222222
222002222222222002222002222222
222002222000000000000000000002
222002222000000000000000000002
222000000002200222222222200222
222000000002200222222222200222
222002222222200220022000000222
222002222222200220022000000222
222000000222200222222222200002
222000000222200222222222250002
222002222222200000000220022222
222072222222200080000220022222
222002222002222220000222200222
222002222002222220000222200222
200222222002200000022220022002
200222222002200000022220022002
222000000000000002222000022002
222000000000000002222000022002
222002222222222222200000000002
222002222222222222200000000002
200002222222222220000002222222
200002222222222220006002222222
222000000000000000000002222222
222000000000000000000002222222
222002222222222222200000000002
222402222222222222200000000032
222222222222222222222222222222
