222222222222222222222222222222
200222222002200002222002222222
200222222002200502222002222222
200000000222200222200000000002
200000000222200222200000000002
222002222222200220000002222222
222002222222200220000082222222
222002222002200000000000000222
222002222002200000000000000222
222002222000000000022222222222
222002222000007000022222222222
222000000002200000000222222002
222000000002200000000222222002
222220022002222222200000000002
222220022002222222200000000002
200000022222222000000222200222
200000022222222000000222200222
222220022220000000022222200222
222220022220000000022222200222
222220022002222220022000000222
222220622002222220022004000222
200000022220000000022220000222
200000022220000000022220000222
200222222220000222222222200002
200222222220000222222222200002
200000000222200222200000000002
200000000222200222200000000002
222222222220000002222222222002
222222222220000002222222222032
222222222222222222222222222222
