222222222222222222222222222222
200000000002222220022222222222
200000000002222220022222222222
222222222002200220000000000002
222222222002200220040000000002
222002222002200222222002222222
222002222002200222222002222222
200002222000000222222000022222
250002222000000222222000022222
222002222002222220022000000002
222002222002222220022000000002
222002222000000000000000022002
222002222000800000000000022002
200000022220022220022222222002
200000722220022220022222222002
200222222220022222222002222222
200222222220022222222002222222
200002200000000000000000000002
200002200000000000000000000002
222002222222222222222002222002
222002222222222222222002222002
222000000000000000000000022222
222000006000000000000000022222
222220022222200220000220000002
222220022222200220000220000002
200000022222200222200222222002
200000022222200222200222222002
222220000002222002200222200002
222220000002222002200222200032
222222222222222222222222222222
