222222222222222222222222222222
200222222222222222222002200222
200222222222222222222002200222
200000000000000000000002200222
200000000000007000000002200222
222222222222222220022000000002
222222222222222220022000000002
200222222220000000022220022002
200222222220008000022220022002
222000000222200220000222222222
222000000222200220000222222222
222002200222200222200222200222
222002206222200222200222200222
222222200222222222200222200222
222222200222222222200222200222
200222200000000000000000000002
200222200000000000000000000002
200000000002200222222222222002
200004000002200222222222222002
222222200222222222222220022222
222222200222222222222220022222
222000000000000000000220000222
222000000000000000000220000222
222220000000022220000000000002
222220000000022220000005000002
200222200222200220022000022002
200222200222200220022000022002
200000000222200000022222222002
200000000222200000022222222032
222222222222222222222222222222
