222222222222222222222222222222
200000022222222222200222200222
200000022222222222200222200222
200000022000000002200222200222
200000022000000002200222200222
222220022002222000000000000222
222220022002222000000000000222
222000000000022222200000000222
222000008000622222200000000222
200002222220022222200222222222
200002222220022222200222222222
222222222222222000000222222002
222222222222222000000222222002
222000000002222002200000000002
222000000002222002200000000002
222002222002200002200222200222
222002222002200002200222200222
222002222002200002200222200222
222402222002200002200222200222
222002222000022220000220000222
222002222000022220000220000222
222002200000000220022220022222
222002200000000220022220022222
222220000220000000022220000002
222220000220000000022220050002
200000022222222000022220022002
200000022222222000022220022072
222222222000000000022220022002
222222222000000000022220022032
222222222222222222222222222222
