222222222222222222222222222222
200222222000000000022220022002
200222222000000400022220022002
200000000002222220022220022222
200000000002222220022220622222
222002222002222222222000000002
222002222002222222222000000072
222000022222200000022222200222
222000022222200000022222200222
200002222222222220022222200222
200002222222222220022222200222
200002200000000000022002200222
200002200000000000022002200222
200222222220022222200000000222
200222222220022222200000000222
200000022000000222200220000002
200000022000000222200220000002
200220000002200000000222222002
200220000002200000000222222002
222220022222200220022222222002
222220022222200220022222222002
200220000002200220000000022222
200220800002200220000000022222
222220000002222220022002222222
222220000002222220022002222222
200000022000022220022000000002
250000022000022220022000000002
222220022222200220022222222002
222220022222200220022222222032
222222222222222222222222222222
