222222222222222222222222222222
200222222222222002200222200222
200222222222222002200222200222
200000000000022002200222200222
200000000000022002200222200222
200002222000000002200000000222
200002222000000002200000000222
222222200002222002200002222222
222222200002222002200002222222
222222200002222002200000000002
222222200002222002200000006002
200002222002222222200222222222
200002222502222222200222222222
222000022000000222200222222222
222000022000000222200222222222
222220022222200000000000000002
222220022222200000000000000002
200000000002222220022002222222
200000008002222220022002222222
200222222000022222222000000222
200222222000022222222000000222
222222200000022002222000022222
222222200400022002222000022222
222002200000000002222000000002
222002200000000002222000000002
222000000002200000000000022002
222000000002200000000000022002
200222222002222222222222222002
200222222072222222222222222032
222222222222222222222222222222
