222222222222222222222222222222
200222200002222222222002200002
200222200002222222222002200002
200222200222200000000002222222
200222206222200000050002222222
200222200220000222222222200002
200222200220000222222222200002
200222200000022220022222200222
200222200000022220022222200222
200222222220022220000002200222
200222222220022220000002200222
200000000000022220022000000222
200000000000022220022000000222
222222200220000000022222200222
222222200220700000022222200222
222000000220000222222002200222
222000000220000222222002200222
222000022222222002200220000222
222000022222222002200220000222
200000000002222222200220022222
200000000002222222200220022222
222222222000000002200000000002
222222222000000002200000008002
222002200002222002222002222222
222402200002222002222002222222
222002222000022000022002222222
222002222000022000022002222222
222000000000022222222000000002
222000000000022222222000000032
222222222222222222222222222222
