222222222222222222222222222222
200000000222222000022000022222
200000000222222000022000022222
222002222220022002222002200002
222002222220022002222002200002
222002200220000000000222200222
222002200220000000000222200222
222000022000000002222220000222
222000022000800002222225000222
222220022002222002200220022222
222220022002222002200220022222
200000000002222000022220000002
200000000002222000022220000002
200222222222222000000220022002
200222222222222000000220022002
200222222000000002200000022222
200222222000000002200000022222
200000022222222002222220022002
200000022222222002222220022002
200222222222222002222220022002
200222222222222062222220022002
200222200000000000000220000222
240222200000000000000220000222
200222222220022002200220000222
200222222220722002200220000222
200220000000022222200222200222
200220000000022222200222200222
200222222220000222200222200002
200222222220000222200222200032
222222222222222222222222222222
