222222222222222222222222222222
200220022222222220000000000002
200220022222222220000000050002
200222200000000222222222200222
200222200000000222222222200222
200002222000000222222222200222
200002222000000222222222200222
222002222002222000000002200222
222082222062222000000002200222
222002200000022000000000000222
222002200000022000000000000222
222002222220000000022222222222
222072222220000000022222222222
222000022220000220022220000002
222000022220000220022220000002
222002222220022220000220022222
222002222220022220000220022222
222002200000022220000000000222
222002200000022220000000000222
222000000220000222222222222222
222000000220000222222222222222
200222200220000000000220022002
200222200220000000000220022002
222002200222222002200222222002
222002200222222002200222222402
222000000002222002200000000002
222000000002222002200000000002
200222222220022002222002222002
200222222220022002222002222032
222222222222222222222222222222
