222222222222222222222222222222
200000000000000002222222222002
200000000000000002222222222002
222222200222222222200000000222
222222200222222222200000700222
200220000222222000022222200222
200220000222222000022222200222
222000022220022220000000000222
222060022220022220000000040222
222000000000000000022222200222
222000000000000000022222200222
200002200222222222222222200002
200002200222222222222222200002
222222200002222222200002222002
222222200002222222200002222002
222222200222200002222002222222
222222200222250002222002222222
200000000000000222222000000222
200000000000000222222000000222
222222222000022220022002222222
222222222000022220022002222222
222222222000022220000000022002
222222222000022220000000022002
200000000002222220022220000002
200000000002222220022220000002
200222200000000000000002222002
200222200000800000000002222002
200220022220000002222002222002
200220022220000002222002222032
222222222222222222222222222222
