222222222222222222222222222222
200222200000000002222222222002
200222200000000002222222222002
200002222220022000000000000222
200002222220022000000000000222
222002222000022222222222222222
222002222000622222222222222222
222002222002200000022002222002
222002222002200000022002222002
222002222002200220022220022002
222002222002200220022220022002
222002222000000220022220000002
222002222000000220022220000002
200000000002200220022222200002
200000000002200220022222200002
200222200222222220000000000002
200222200222222220000000000002
200222200000022222222220022002
200222200000722222222220022002
222222200222222002222000022222
222222200222222002222000022222
222002200000000002222002222222
222502200000000082222002222222
222000022220022222222000000002
222000022220022222222000000002
200220022000022220022220022222
200220022000022220022220022222
200220000000022220000000000002
200220000000022220040000000032
222222222222222222222222222222
