222222222222222222222222222222
200222222222200002222000022222
200222222222200002222000022222
200000000002222002222220000002
200000000002222002222220000002
200002222222200002200222222002
200002222222200002200222222002
222002222222200222200222200002
222002222222200222200222200002
222000000000000000000000000222
222000000000000000000000000222
222222200222200220000222222222
222222200222200220000222222222
200002200222200222200222222002
200002200222250222200222222002
222002200222200002222220000002
222002200222200002222220000002
222000000002222222222220022002
222070000002222222222220022002
200222222002222000000222222002
200222222002222000040222222002
200220022000022220000000000002
200220022000022220000000008002
222220000000022220022222222222
222220000000022220022222222222
200000000222222000000002222222
200060000222222000000002222222
222222200000000002222000000002
222222200000000002222000000032
222222222222222222222222222222
