222222222222222222222222222222
200000000000000222200002222002
200000000000000222200002222002
222002222220022220022002222002
222002222220022220022002222002
222002222000022002222002222002
222002222000022002222002222502
222002222220000000022002200002
222062222220000000022002200002
222000000002200000000000000222
222000000002200000000000000222
222002222002200222222002200222
222002222002200222222002200222
222002222002200002222002200222
222002222002200002222002200222
222002222002222222200002200222
222002222002222222200002200222
222220022002200220000222200222
222220022002200220000222200222
200222222000022002222220000222
200222222000722002222220000222
200220000002222220022222200002
200220000002222220022222200002
200220022222200000022002222002
200220022222200000022002222002
200000000222222000000000022002
200080000222222000040000022002
222222200000000002222222222002
222222200000000002222222222032
222222222222222222222222222222
