222222222222222222222222222222
200222200220022222200222222222
200222200220022222200222222222
200000022220022000000000000002
200000022220022000000000000002
222220022220000000022222222002
222220022220000000022222222002
222000022220000220022222222222
222000022220000220022222222222
222000022222222220022000000222
222000022222222220022000000222
200000000002222000022222200222
200000000002222000022222200222
222220022222222002222220000222
222220722222222002222220000222
222000000220000000000220000222
222000000220000000000220000222
222002200220000222200000022222
222002200220000222200000022222
200002200222200002222220000002
200002200222200002222220000002
222220000000000002222222200222
222225000000000002222222208222
222000022002222222200002200222
222000022002222222200002200222
200222222002222000000222200222
200222222002222004000222200222
200002200000000002222002200002
200002206000000002222002200032
222222222222222222222222222222
