222222222222222222222222222222
200222222222222220022220022222
200222222222222220022220022222
200000000000000220022220000002
200000000000000220022220000002
200220000002222220022220022002
200220000002222220022220022002
200222222222222000000220022002
200222222222222070000220022002
200222222220000002200000022222
200222222220040002200000022222
200000000222222222200220000222
200000000222222222200220000222
200002222220022220000222222222
200002222220022220000222222222
200002222220000222200222200002
200002222220000222200222250002
200000000000000000000222222002
200060000000000000000222222002
200222200222222222222220000002
200222200222222222222220000002
222000000002222222200220022222
222080000002222222200220022222
222002222000000000022220000222
222002222000000000022220000222
222002222002222000000000000222
222002222002222000000000000222
222002222002222002222000000002
222002222002222002222000000032
222222222222222222222222222222
