222222222222222222222222222222
200222200000022220022000022222
200222200000022220022000022222
200222200222222220022002222002
200222200222222220022002222002
200000000222200000022000022002
200000000222200000022000022002
200222200220022220022220000002
200222207220022220022220000002
200220000222222220000000022222
200220000222222220050000022222
222220022220000000022220000002
222220022220000000022220000002
222220022002222002200222222002
222220022002222002200222222002
200220000222222002200222222002
200220040222222002200222222002
200220022220000000000220022222
200220022220000060000220022222
200000000000022222200000000222
200000000000022222200080000222
200002200222222000000222200222
200002200222222000000222200222
222002200002222002200222200222
222002200002222002200222200222
222002222002222002222220000222
222002222002222002222220000222
222002222002222002200220000002
222002222002222002200220000032
222222222222222222222222222222
