222222222222222222222222222222
200222222220000002222222222222
200222222220000002222222222222
200220000000022222200000000002
200220000070022222200000000002
200222222220000002222002222222
200222222220000002222002222222
200002222220022222200002222002
200002222220022222200002222002
222000000220000220000220000222
222000000220000220000220000222
222002200220000220000220022222
222002200220000220000220022222
222222200222200000000220022002
222222200222200000000220022002
200222200002222222200220022002
200222200002222222200220022002
200222200000022220000000000002
200222200000022220006000000002
200220000000000000022222200002
200220000000000000022222200002
200000022222222220000002222222
200000022222222220000002222222
200222222222222222222000022222
240222222222222222222500822222
200002200000000000000000000002
200002200000000000000000000002
222222200222222222222222222002
222222200222222222222222222032
222222222222222222222222222222
