222222222222222222222222222222
200222200002222000000000022002
200222200002222000000005022002
200222222000000002222222222002
200222222000800002222222222002
200000000000000220022220000222
200000000000000220022220600222
222220022222222222200220022222
222220022222222222200220022222
200220022222222002200220022002
200220022222222002200220022002
200220000000000002200000000002
200220000000000002200000000002
222220022222200222200222222002
222220022222200222200222222002
200000022220000000000002222002
200000022220000000000072222002
222222222000022222222002222222
222222222000022222222002222222
222002200002222220000000000222
222002200002222224000000000222
222000000222200220000222200222
222000000222200220000222200222
222002200220000000022222200002
222002200220000000022222200002
222002222220022220000002222002
222002222220022220000002222002
222002222000022002222002222002
222002222000022002222002222032
222222222222222222222222222222
