222222222222222222222222222222
200222222220000002222220022222
200222222220000002222224022222
200220000000022000000000000002
200220000000022000000000000002
200222200222222002222220022222
200222200222222002222220022222
200000000002222220022220000222
200000000002222220022220000222
222002222000000000022220000222
222002222005000000022220000222
222002200222200000000222200222
222002200222200000000222200222
222002200222222002222002200222
222002200222222002222002200222
222002222000000002200222222222
222002222000000072200222222222
222002200002200222200220000002
222002200002206222200220000002
222002200222200000000222222002
222002200222200000000222222002
222002200002222222200002222002
222002200002222222200002222002
222002222000000002222002222002
222002222000000002222002222002
222000022220022222200000000002
222080022220022222200000000002
222002222000022000000222222002
222002222000022000000222222032
222222222222222222222222222222
