222222222222222222222222222222
200222200222200220000000000002
200222200222200220000000000002
200000000222200222222220000222
200000000222200222222220000222
222002222222200222222220000222
222002222222200222222220000222
222002222000000000000222200222
222002222000000005000222200222
200002222002222222222220000002
200072222002222222222220000002
200222200002222222222222200002
200222200002222222222222200002
200222222000000000000002222002
200222222000000000000002222002
200000022220022222222000000002
200000022220022222222000000002
200000022220000222222222222222
200000022220000222222222222222
200002222000000000000002222222
200002222000000000000002222222
200002222002222222222000000002
200002222002222222222000000062
222000000002222000022220022002
222000000082222000022220022002
222002222002200000000000022002
222402222002200000000000022002
222002200222200222222222222002
222002200222200222222222222032
222222222222222222222222222222
