222222222222222222222222222222
200222200002200002200002222002
200222200002200002200002222002
200000022222222002222220000222
200000022222222002222220000222
200220022000000000000000000222
200220022000000000700000000222
200220022220022222222222200222
200220022220022222222222200222
200222222000000220022222200222
200222222000008220022222200222
200222222220000002200000000222
200222222220000002200000000222
200000000000022002222222222002
200060000000022002222222222002
200222200222222222200222222222
200222200222222222250222222222
222220000002200220000220000002
222220000002200220000220000002
222000022002200220000000022002
222000022002200220000000022002
222000022000000000022222222002
222000022000000000022222222002
222220022220022220000222222222
222220022220022220000222222222
200000022220022222200000000222
200000022220022222200000000222
222222200220000002222222200002
222222200224000002222222200032
222222222222222222222222222222
