222222222222222222222222222222
200000000000000222200220022222
200000000000000222200220022222
222002222222222220022220022002
222002222222222220022220022002
222000000002222000022220022002
222000000002222400022220022002
222222200220022220022220022002
222222200220022220022220022002
200002200222200220022000022002
200002200222200220022000022002
222000000000000000000000000002
222000700000000000000000000002
222000000000022002222002222222
222000000000022002222002222222
222002222222222002222000000222
222002222222222002222000000222
222002222220022002222222200222
222002222220822002222222200222
222000000002222222200222200222
222000050002222222200222200222
222002200002200002200220000222
222002200062200002200220000222
200002222222222000000220022222
200002222222222000000220022222
200000000000000002222220000002
200000000000000002222220000002
222222222222222002200002222002
222222222222222002200002222032
222222222222222222222222222222
