222222222222222222222222222222
200222222220000002222002222222
200222222220000002222002222222
200000000222200222200000000002
200000000222200222200000000002
222220022220000222222000022002
222220022220000222222000022002
200220000000000000000002222002
200220000000000060000002222002
200220022002222002222002222222
200220022002222002222002222222
222000022002222000022000000222
222000022002222000022000008222
222220022002222000000222200002
222220022002222000000222200002
200220022002222000000222222002
200220022002222000000222222002
200000022000022222222220022222
200000022000022222222220022222
222002222002222220022220022222
222002222002222220022224022222
222002222000000220022000000002
222002222000000220022000000002
222002200222200000000002222222
222002200222200000000002222222
222002222220000222200222222222
222002222220000222200222222222
222000000222222220000000000002
222500700222222220000000000032
222222222222222222222222222222
