222222222222222222222222222222
200000000002200222222002222222
200000000002200222222002222222
222222200222200220022002200002
222222200222200220022002200002
200000000222200000000002200222
200000800222200060000002200222
222222200002222222222000000222
222222200002222222222000000222
222000000000022220022222200222
222000000000022220022222200222
222002222220022220022222200222
222002222220022220022222200222
200002222220000000000000000002
200002222220000000000000000402
222222200222222222222220022222
222222200222222222222220022222
222222200222200222222220022222
222222200222200222222220022222
200000000220022000000000022002
200000000220022000000000022002
222222200220022220022000022002
222222200220022220022070022002
200220000000000000022220000002
200220000000000000022220050002
222220022222222000022002222002
222220022222222000022002222002
200000000000022220000222200002
200000000000022220000222200032
222222222222222222222222222222
