222222222222222222222222222222
200000022222200222200222222222
200000022222200222200222222222
222220022000000222200000000002
222220022000000222200000000002
200000000002222220000002222002
200000000002222220000002222002
222220000000022220022222200002
222220000000022220022222200002
222220022222222220022220000222
222220022222222220022220000222
200000000000000220022220022222
200000006000000220022220022222
222222222222200220022220022002
222222222222200220022220022402
222002222220000000000220000002
222002222220800000000220000002
222000000222222002222222222002
222000000222222002222222222002
200002200220022002222002222002
200002200220022002222002222002
200222200222222002222002222002
200222207222222002222002222002
200222200000022002222002222002
200222200000022002222002222002
200222222220000002222000022002
200222222220000002222000022002
200000022220000000000000022002
200500022220000000000000022032
222222222222222222222222222222
