222222222222222222222222222222
200002222222222220000002222222
200002222222222220000002222222
222000000000000000022222200002
222000000000000000022222200002
222002222222222222200222200222
222062222222222222200222200222
222002222220000002222000000222
222002222220000002222000000222
222000000220022002222002200222
222000000220022002222002200222
222002200000022000000002200222
222002200000022000000402200222
222002222220022222222222222222
222002222220822222222222222222
222000022220000222222000000002
222000022220000222222000000002
222222200220022220022000000002
222222200220022220022000000002
200222222220022000022000022222
250222222220022000022000022222
200000000220000002200000000222
200000700220000002200000000222
222222200000022002222000000222
222222200000022002222000000222
222222222002222000022222200222
222222222002222000022222200222
200000000000022220000000000002
200000000000022220000000000032
222222222222222222222222222222
