222222222222222222222222222222
200000000000000222222002200002
200000000000000222222002200002
200222200220000000000002222002
200222200220000000007002222002
200222200222222002222002200222
200222200222222002222002200222
222222200002222002222002200222
222222200002222002222002200222
222002222002200222222002200222
222002222002200222222002200222
222002222000022000000000000222
222002222000822000050000000222
222002222220022002200002222002
222002222220022002200002222002
222000000220022002222002222222
222000000220022002222002222222
222002200000022222222000000002
222002200000022222222000000002
222222200220022220022002222002
222222200220022220022002222002
200000000220022220000002200002
200000000220022220006002200002
222002200220022222222220000222
222002240220022222222220000222
222002200220000000000220022222
222002200220000000000220022222
222002222002222222222220000002
222002222002222222222220000032
222222222222222222222222222222
