222222222222222222222222222222
200000000000000002222222222222
200000000000000002222222222222
222002222222200000000000000002
222002222222200000000000000002
222222200222200222200222222002
222222200222200222200222222002
200222200222200222200220000002
200222200222200222200220000002
200000000000000002222222222222
200000000000050002222222222222
200002222222222220022002200222
200002222222222220022002240222
222002200222222222222000000222
222062200222222222222000000222
222002222000000000022002222002
222002222000000000022002222002
222000022222200220000002222002
222000022222200220000002222002
222002200220000222222000000222
222002200220000222222000000222
222002200220022222222222200222
222002200220022222222222208222
222000022220000000000222200222
222000022220000000000222200222
200000022220000222200220000002
200000022220000222200220000002
200000000000022220000222222002
200000700000022220000222222032
222222222222222222222222222222
