222222222222222222222222222222
200222200000000000000000022222
200222200000000000000000022222
200000000222222222222220000002
200000000222222222222220000002
222222200222200222222002200222
222222200222200222222002200222
200220000000000220000222200222
200220000000000220000222200222
200222200002222222200002200002
200222200002222222200062240002
222002222002222002200222222222
222002222072222002200222222222
222002222002222000000000000222
222002222002222000000000000222
222000000002222002222220022222
222000000002222002222220022222
222002222002222222222220022002
222002222002222222222220022002
222000022222200000000000000002
222000022222200000000000000002
222220000002222222200002222002
222220000002222222200002222002
200222200002222222200002222222
200222200002222222250002222222
200000000000000000000000000222
200000000000000000000000000222
222220000222222222222220000002
222220008222222222222220000032
222222222222222222222222222222
