222222222222222222222222222222
200222200002222220022000022222
200222200002222220022000022222
200000000000000000022222200002
200000000000000000722222200002
222000022220022222222000000222
222000022220022222222000000222
222002222000000222222220000222
222002222000000222222220000222
222002222002222220000000022222
222002222502222220000000022222
200002222000022222222220000002
200002222000022222222220000402
200222200220000002222220022222
200222200220000002222220022222
200222200222222222200000000222
200222200222222222200000000222
200000000220022002222002222002
200000000220022002222002222002
222002200222222002222000000222
222002200222222002222000006222
222002222220022000000222200222
222002222220022000000222200222
222002222220000002200000000222
222002222220000002200000000222
200000000000022222222000000222
200000000000822222222000000222
222222222220000000022220000002
222222222220000000022220000032
222222222222222222222222222222
