222222222222222222222222222222
200222222002222000022222222222
200222222002222000022222222222
200000000002200222200000000002
200000000002200222200000000002
222002222002200222222002222222
222002222002200222222002222222
222002222000000000000000022222
222002222000000000000000022222
222222200002200222200220000002
222222200002200222200220000002
200222222222200222200222200222
240222222222200222200222200222
200000022222200222200222200222
200000022222200222200222200222
222220022000000222222220000222
222220022000000222222220000222
222000022220022220022222222222
222000822220022220022222222222
222000000220022220000002200002
222000007220022220000002200002
222000000000022222200222200222
222000050000022222200222200222
200002222000000000000002200222
200002222060000000000002200222
200222222222222000000000000002
200222222222222000000000000002
200220000000000000022222222002
200220000000000000022222222032
222222222222222222222222222222
