222222222222222222222222222222
200000000000000000000222222222
200000000000000000000222222222
200222222222222220022220000002
200222222222222220022220000002
200222200002222222200222222002
200222200002222222200222222402
200000000000000002222000022002
200000000000000002222000022002
222222200222222002222220000002
222222200222222062222220007002
222220000000022222200000022222
222220000000022222200000022222
200220022222222220000222200222
250220022222222220000222200222
200000022220000222200220022002
200000022220000222200220022002
222220022220022222200220022002
222220022220022222200220022002
222000000000000000000222222002
222000000000008000000222222002
200222200222222222200220022002
200222200222222222200220022002
222222200222200002200000022002
222222200222200002200000022002
200000000002200000000220000002
200000000002200000000220000002
222222222222200222200222222002
222222222222200222200222222032
222222222222222222222222222222
