222222222222222222222222222222
200222200000000222222002222222
200222200000000222222002222222
200000000222200000022002200002
200000000222200000822002200002
222220022220000222222000000002
222220022220000222222000000002
222000000222200002222002222222
222000000222200502222002222222
200220022222222222200000022002
200220022222222222200000022002
200220000000000220000220022222
200220000000000220000220022222
200220022222200220000220000002
200220022222200220700220000002
222220000222200220000222222222
222220000222200220000222222222
200222222222200000000220022002
240222222222200000000220022002
200222200000000222200000022002
200222200000000222200000022002
200220022220022002222220022222
200220022220022002222220022222
200222222220022220022220000002
200222222220022220022220000002
200000000000022000000000022002
200000000000022000000000022002
222222222222222002222222222002
222222222222222062222222222032
222222222222222222222222222222
