222222222222222222222222222222
200222222222200222200000000222
200222222222200222200000000222
200000000000000220022222200222
200000000000000220022222200222
200222200222200222200000000222
200222200222200222200000000222
200002222220000220000220022222
200002222220000220000220022222
200000022220022220022222222002
200000022220022220022222222402
222002222222222220000002222002
222002222222222220000002222002
222000000000000000022002222002
222000000000000000022002222002
222222200220000222222002222002
222222200220000222222002222072
200000000222222222222222222002
200500000222222222222222222002
222222200000022000000000000002
222222200000022000800000000002
200002200220000002200222222222
200002200220000002200222222222
222002200222222222200000022002
222002200222222222200000022002
222000000222222000000002222222
222000000222222000000002222222
222002222220000002222000000002
222002222220000062222000000032
222222222222222222222222222222
