222222222222222222222222222222
200000000000022222222222200002
200000000000022222222222200002
200222200220000000000000022002
200222200220000000000000022002
222222200220000222222220022002
222222200220000222222220022002
222002200222200000022220022002
222002206222200000022220022002
222002200002222222222220000222
222002200002222222222220000222
222000000002200222200222200222
222000000002200222200222200222
222002222222222002200222200222
222002222222222002200222200222
222002222000000002200222200222
222002222000000002200222200222
200000022220022000000220000222
200000022220022000000220007222
222220022000022002200000000002
222220022000022002200000000002
200220022222222002222002222002
200220022222222402222002222002
200220022222200002222002200002
200220022222200002222002200002
200220000002222222222002200002
200220000502222222222082200002
200220022220000220000002222002
200220022220000220000002222032
222222222222222222222222222222
