222222222222222222222222222222
200002222002222222200222200222
200002222002222222200222200222
222002222002200002200000000222
222002222002200002200000000222
222002222002200222200222222002
222002222002200222200222222002
222002222000000000000222200002
222002222000000000000222200002
222002222220022222200000022222
222002222220022222200000022222
222000000000022222200220000002
222000000000022222200220040002
200000000002222002200222200222
200000000002222002200222200222
222222222002222000000222222222
222222222002222000000222222222
200002222000022222222220022002
200002222000022222222220022502
200220022220022222222220000002
200220022220022222222220000072
200220000000000000000220000222
200220000000000000006220000222
222222200220022222222220000222
222222200220022222222220000222
200002200220000000022220022222
200002200220008000022220022222
200000000222222220000000000002
200000000222222220000000000032
222222222222222222222222222222
