222222222222222222222222222222
200222200222222002222222200002
200222200222222002222222200002
200222200000022000000000022222
200222250070022400000000022222
200222222220000000022220022002
200222222220000000022220022002
200000000222222222200000000002
200000000222222222200000000002
222222200000022222222222222002
222222200000022222222222222002
222000000000022000022220000002
222000000000022000022220000002
222002222000022002200222200222
222002222000822002200222206222
222002222000000002222002200222
222002222000000002222002200222
222002222222200222222000000002
222002222222200222222000000002
222000000002200000022220022222
222000000002200000022220022222
200222222222200222222000000222
200222222222200222222000000222
222222222222200222200002222002
222222222222200222200002222002
200000000000000000000002222222
200000000000000000000002222222
200002222002222222222000000002
200002222002222222222000000032
222222222222222222222222222222
