222222222222222222222222222222
200222222220000222200222222222
200222222220000222200222222222
200220000222200220000000000002
200220000222200220000000000002
200000022222200220000220000222
200000022222200220000220000222
200220022000000222200222222222
200220022000000222200222222222
200220022000022222200000000002
200220022000022222206000000002
200220022220022000000222200222
200220022220022080000222200222
200220022220000000000222200222
200220022220000000000222200222
200220000000000222200222200222
200220000000000222200222200222
222220022222222220000222200222
222220022222222220007222200222
222002222222222220022002200222
222002222222222220022002200222
200222200000000222222222200222
240222200000000222222222200222
200222200222200000000002200002
200222200222200000000002200002
200000000220000220022222222002
200000000220000220022222222002
222222200222222220000000000002
222222200222222220000500000032
222222222222222222222222222222
