222222222222222222222222222222
200222222222222220000000022222
200222222222222220000000022222
200000000000000002222222200002
200000006000000002222222200002
222222222222222000000000000222
222222222222222000000000000222
222002222002200222200222200222
222002222002200222200222200222
222002222002222222200222200222
222002222002222222200222200222
222002222000000000022222200222
222002222400000000022222200222
222000022222200000022000000222
222000022222200000022000000222
222002222000022002222002200222
222002222000822002222002200222
200000000002222002200002222002
200000000002222002200002222002
200222200000000002222002200002
200222200000000002222002200002
200220022220000222222002200002
200220022220000222222002200002
200222222222200000000002222222
200222222222200000000002222222
200220000000000000022000000002
250220000000000000022000700002
200222222222200222222002222002
200222222222200222222002222032
222222222222222222222222222222
