222222222222222222222222222222
200002222220022222222000000222
200002222220022222222000000222
200222200220022000022002200222
200222200220022000022002200222
200222200220022220022002200222
200222200220022220022002200222
200000000000022220000002222222
200000000000022220000002222222
222222222002200000022002222002
222222222002200000022002222002
222222222002222220022222200002
222222222002222220022222200002
200000000002222000022220000222
200000000002222000022224000222
200222222000022220022220022222
200222222000022220022220022222
200002222002222220000000000002
200002222002222220000000008002
222222222000000000000002222222
222222222000000000000002222222
222220000000000222222000000222
222220700000000222222000000222
200000022000000002222002222222
200000022000000002222002222222
200222222220022222222002222002
200222222220022222222002222002
222220000000022220000000000002
222220050000022220006000000032
222222222222222222222222222222
