222222222222222222222222222222
200000022222222002222002200222
200000022222222002222002200222
222220022000022000000222200222
222220022000022000000222200222
222000000000000002222220000002
222000000000000002222220000002
222002222002222002222222222002
222002222002222002222222222002
222002222222222222200002222002
222002222222222222200002222002
222000000000000222200000000002
222000000000000222200000000002
222002222222200002222002222002
222002222222200002222002222402
222002222000000002222000022002
222002222000000002222000022002
200000000220022222222220022222
200000000220022222222220022222
200222222220022220000000022222
200222222220022220000000022222
222222200220000220022220000002
222222200220000220622220000002
222000022002200000022220022222
222000022002200000022220022222
222002222002200222222000000002
222002222002207222222000000082
200000000000000222200002222002
250000000000000222200002222032
222222222222222222222222222222
