222222222222222222222222222222
200222200000022222222002222222
200222200000022222222002222222
200000000220022000000000000002
200000000220022500000000000002
200220022220000222222222200002
200220022220007222222222200002
222220022220022222222220000002
222220022220022222222220000002
200220022220022000000222222002
200220022220022000000222222002
222000022000022220022220000002
222000022000022220022220000002
222222222002222220022220000002
222222222002222220022220000002
200222222000000000000000000222
200222222000000000000000000222
200000022222200222222222200222
200000022222200222222222206222
222220022222200222222222200222
222220022222200222222222200222
222000000000000000000002200222
222000000000000000000002240222
222002200222222002200222222222
222002200222222002200222222222
222222200220022222200000000002
222222200220022222200000000002
200000000222200000000222200002
200080000222200000000222200032
222222222222222222222222222222
