222222222222222222222222222222
200222222222200000000222222002
200222222222200000000222222002
200000000000000222200000022002
200000000000000222200400022002
200222222002222222222222222002
200222222002222222222222222002
222222200000000000022002200002
222222200000000000022082200002
222000000222222220022222200222
222000000222222220022222200222
222000022220000220000002200222
222000022220000220000002200222
222220022002200002222000000002
222220022002200062222000000002
200222222222222000000002222002
200222222222222000000002222002
200222200000000002222222200002
200222200000000002222222200002
200222200222222000000002222002
200222200222222000000002222002
200222200222222220022002222002
200222200222222220022002222002
200222200000000220022222200002
200222200000000220022222200502
200000000222222220022222222002
200000000222222220022222222002
222222200220000002222000000002
222222207220000002222000000032
222222222222222222222222222222
