222222222222222222222222222222
200000000222200000022222200222
200000000222200000022222200222
200222200222200002222002200222
200222200222200002222402200222
222220000000000002200000000002
222220000000000072200000000002
222000000000000000000222222002
222000000000000000000222222002
222002222222222222200220022002
222002222222222222200220022002
222002222222222002200002200002
222002222222222002200002200002
222000000000022000000002222222
222000000000022000000002222222
222002222222222002222002200222
222002222222222002222002200222
222000000222222000022002222002
222080000222222000022002222002
222002222220022220022000000002
222002222220022220022000000002
222002222220000222222002200222
222002222220000222222002200222
200002200222200222222002200222
200002200222200222222002250222
200222200000000000000002222222
200222200000000000000002222222
222220000222222222222000000002
222220000222222222222000600032
222222222222222222222222222222
