222222222222222222222222222222
200002222002222002200222200222
200002222402222002200222200222
222002222002200222200222200222
222002222002200222200222200222
222002200000000222200000000222
222002200000000222200000000222
222002200222200000000002200222
222002200222200000000002200222
200000000002200222222002222222
200000000002200222222002222222
200220000222200220022002222002
200220000222200220022002222002
200222200222200222222000000002
200222200222200222222000000002
200222200220022000022222222002
200222200220022070022222222002
200220000002222000022220022002
200220000002222000022220022002
222220022222222220022002222222
222220022222222220022002222222
222000000000000000000000000222
222000000000000000000000000222
200002200222222220022220000222
250002206222222220022220000222
200222200222200000000220022222
200222200222200000000220022222
200002222220000222222220000002
200002222220000222222220800032
222222222222222222222222222222
