222222222222222222222222222222
200222222222200000000000000002
200222222222200000000000000002
200000000000000000022222222002
200000000000000000022222222002
200220022222222002222222222002
200220022222222002222222222002
222220000222222222200000022002
222220000222222222200000022002
222000000000000222200220000002
222000000000000222200220000002
222000000222200222200222222002
222000000222200222200222222002
222220000002222220022220022002
222220000002222220022220022402
200000022222222220022000000002
200000022222222220022000800002
222220000220000000000002200222
222220000220000000000062207222
222222200222222002222222200222
222222200222222002222222200222
200000000220022002222002200222
200000000220022002222002200222
222220022222222002222000000222
222220022222222002222000000222
200220022000000002222002222222
200220022000000002222002222222
200220022222222002222000000002
200220022222222502222000000032
222222222222222222222222222222
