222222222222222222222222222222
200002222000022220022222200002
200002222000022220022222250002
222002200220000000022002200002
222002200220000000022002200002
222002222220022222222002200222
222002222220022222222002200222
222002200000000002222002200222
222002200000007002222002200222
222000000222222222222002200222
222000000222222222222002200222
222002200000022220000002200222
222002200000022220000002200222
222002222000022220022222200002
222402222000022220022222200002
222002222000000220000220000222
222002222000000220000220000222
222222222220022220022222200222
222222222220622220022222200222
200000000000022220022000000222
200000000000022220022000000222
200222222220000000000000000222
200222222220000000000000000222
200222222222222002200002200222
200222222222222002200002208222
200000000002222002222002200002
200000000002222002222002200002
200222222000022220022002200002
200222222000022220022002200032
222222222222222222222222222222
