222222222222222222222222222222
200000000002222222222222222002
200000000002222222222222222002
222222222002200000000000000222
222222222082200000000000000222
222002222000000002222220000222
222002222000000002222220000222
222002222222200000022220022002
222002222222207000022220022002
222000000000000222222220022222
222500000000000222222220022222
200222222220022222200000000002
200222222220022222206000000002
200220000000022002222222200222
200220000000022002222222200222
222222222000000002222222200222
222222222000000002222222200222
200000000002222220000000000222
200400000002222220000000000222
222000000000000222222002200222
222000000000000222222002200222
222000022220022222200002200002
222000022220022222200002200002
222000022220022000000222222002
222000022220022000000222222002
222000022220022220022000000002
222000022220022220022000000002
222000022220022220022222222002
222000022220022220022222222032
222222222222222222222222222222
