222222222222222222222222222222
200000000002222222222222222222
200000000002222222222222222222
222222222000000000000000000002
222222222000000080000000000002
222002200002222222222002222222
222002200002222222222002222222
222002222002222222222000022222
222002222002222222222000022222
222002200000000000022220022002
222002200000000000022220022002
200000000000000002222220000002
200000000000000002222220000002
222222200000000002200000000222
222222200000000002200000000222
222000000002200002222222200222
222000000002200002222222200222
222002222222200222222002200222
222002222222200222222502200222
200222200000000220000000000222
200222200000000220000000000222
222222222222222220000222200222
222222222222222220000222200222
200000022222222220000222200002
200000622222222220000222200002
200220000000000000000222222002
200220000004000070000222222002
200222222222222222200000022002
200222222222222222200000022032
222222222222222222222222222222
