222222222222222222222222222222
200000022220022222222222222002
200000022220022222222222222002
200222222000022000000000022002
200222222005022000000000022402
200000022220000002200222222002
200000022220000072200222222002
200220022220022222200220000002
200220822220022222200220000002
222220000000022222222220022222
222220000000022222222220022222
200220000220000000000220022002
200220000220000000000220022002
222000022220022002222220022002
222000022220022002222220022002
222002222222222002222220000222
222002222222222062222220000222
222222200002222000000000022222
222222200002222000000000022222
200222222002200000022000000002
200222222002200000022000000002
200000000000000222222002222222
200000000000000222222002222222
222220022002200002222222200222
222220022002200002222222200222
200000022002222000000000000222
200000022002222000000000000222
222222222002200222222222200002
222222222002200222222222200032
222222222222222222222222222222
