222222222222222222222222222222
200222222222222220000000000002
200222222222222220000000000002
200000000000000000022222222002
200000000000000000022222222002
200222222222222222222222222002
200222222222222222222222222002
222222200222222002200000000002
222222200222222002200000000002
222000022000022000000222200002
222000022004022000000222200002
222000022220000002200220022222
222000022220000002200220022222
200002222000022222200222200222
200002222000022222200222200222
222000022002222002200000022002
222000022002222002200000022002
222000000002222000000000022002
222000006002222000000000022002
200222200002222222222220000002
200222200002222222222225000002
222000000000000222200220022222
222000000000000222200220022222
222002222002200000022222222222
222002222002200000022222222222
222002222002200220000000000002
222002222002207220000080000002
222002222002200222222222222002
222002222002200222222222222032
222222222222222222222222222222
