222222222222222222222222222222
200002222222200000000000000002
200002222222200000000000000002
222000000002200222222222222222
222000000002200222222222222222
222002222002200222222002200222
222002222002200222222002207222
222002222000000220000000000222
222002222000000220000000000222
222000000220022220022222200222
222000000220022220022222200222
222000022220000000000222200002
222000022220000000000222200002
200220022220022000000222222002
200220022220022000000222222002
222220022220022000000000022222
222220022220022000000000022222
200220022220022002200220022222
200220022220022002200220622222
200000000220022002200220000002
200000000220022002200220000002
200222222220022222200222222222
200222222220022222200222222222
200220022000022222200002222222
200220022000022222200002222222
200002222002222002222000000002
200002222502222002222000008002
222220022002222000000002222002
222220022002222004000002222032
222222222222222222222222222222
