222222222222222222222222222222
200000022222222220000222200222
200000022222222220000222200222
222220022000000222200000000222
222220022000000222200000000222
222220022002200000000222200222
222220022002200000000222200222
200000000002200222200222200222
200000000002200222200222200222
200222222002200000000222200222
200222222002200000000222200222
222222222222200220022002200222
222222222222200220822002200222
222000000222222220022220000002
222000000222222220022220000002
222002200220000002222220000222
222002200220000002222220000222
222002200000022002200222200222
222002200000022072200222200222
222002200000022000000222200222
222002200000022000000222200222
222002200002222220022222200222
222402200002222220022222200222
200220022222200000022002200222
200220022222200500022002200222
222222222220000220000000000002
222222222220000220600000000002
200000000000000222222002222002
200000000000000222222002222032
222222222222222222222222222222
