222222222222222222222222222222
200000000222200222222222222222
200000000222200222222222222222
222000000222200000000000000002
222000000222200000000000600002
222002222222222222222222200222
222002222222222222222222200222
222002222000022220000222200222
222002222004022220000222200222
222002222002222220000222200002
222002222002222220000222200002
222002222000000000022220000002
222002222070000000022220000002
222002200002222220000220000222
222002200002222220000220000222
200002222222222222200000022222
200002222222222222200000022222
222002222220000000000000022002
222002222220000000000000022002
222000000000022002222000000002
222000000000022002222000050002
200222200002222222222002222222
200222200082222222222002222222
222222222000000220000000000222
222222222000000220000000000222
200000000002222002222002200222
200000000002222002222002200222
200222222002200000022002200002
200222222002200000022002200032
222222222222222222222222222222
