222222222222222222222222222222
200002222222222222200000022002
200002222222222222200000022002
200222200000000000000222222222
200222200000000000000222222222
200220000002200220022220000002
200220000002200220022220000002
200222222222200222222222222002
200222222222200222222222222002
200000000002200000000002222002
200000000002200060000002222002
200222222220000222222000000002
200222222220000222222000000002
200222222220022220000002222222
200222222220022220000002222222
200000000220022220022000022222
200004000220022220022000022222
200222222220022222222220022002
200222222220022222222220022002
200000022220022002200000000002
200000022220022002200000008002
222000022220000002200002222222
222000022220000002200002222222
222220000000022002222002222222
222220000000022002222002222222
200000000222222002200000000002
200000000222222002250000000072
222222222002200002222222222002
222222222002200002222222222032
222222222222222222222222222222
