222222222222222222222222222222
200222222000000220022002222222
200222222000000220022002222222
200000022222200220022000000002
200000022222200220022000000002
200220000000000222222220022222
200220000000000222222220022222
200222222000000000000000000222
200222222000000000000000000222
200002222222222002222222200222
200002222222222002222222200222
222222200222200000000220000222
222222240222200000000220000222
200222200000000002222220000222
200222200000000002222220000222
222000022222222002222000000002
222000022222222002222000000002
222220022222200002222002222222
222220622222200072222002222222
200000000000000222200002200222
200000000000800222200002200222
200222200222222000000222200222
200222200222222000000222200222
200222200222200002200222200222
200222200222200002200222200222
222220000002200222200000000002
222220000002200222200000000002
200002222222200220022222222002
200002222222250220022222222032
222222222222222222222222222222
