222222222222222222222222222222
200222222222200220022222222222
200222222222200220022222222222
200000000000000222200000000002
200000000000000222200000000002
200222222220000222200000022222
200222222220050222200000022222
200000022222222222200002200002
200000022222222222200002200002
200000000002222000000222200222
200000000002222000000222200222
200002222002222220022222200222
200002222002222220022222200222
222220022002200000000000000222
222220022002200000000000000222
222002222000000002222220022222
222082222000000002222220022222
222002222002200220022220000002
222002222002200220022220000002
222000000002200222200000000222
222000700002200222200000000222
222002222002200222200002222222
222002222002200222200002222222
222002222002200002222002222002
222002222002200002222002222402
222002222222200002222002222002
222002222222200002222002222002
222000000220022220022000000002
222000600220022220022000000032
222222222222222222222222222222
