222222222222222222222222222222
200222200000000000000222200222
200222200000000000000222200222
200222222222222002200222200222
200222222222222002200222200222
200000022222222002200000000222
200000022222222002240000006222
200220022000022220000222200222
200220022000022220000222200222
200220000002222222200002222002
200220000002222222200002222002
222220022002200000000000022222
222220022072200000000000022222
222002222000000002222220000002
222002222000000002222220000002
200222222002222002222000022002
200222222002222002222000022002
200000000002200002200000022222
200000800002200002200000022222
200222222002200222200222222222
200222222002200222200222222222
200222222002222220000000000002
200222222002222220000000000002
200000022222222222222002222222
200000022222222222222002222222
222220000000000002222000000002
222220000000000002222005000002
222000022222222000022222222002
222000022222222000022222222032
222222222222222222222222222222
