222222222222222222222222222222
200222200222200002222002200002
200222250222200002222002200002
200000000222200002222002222222
200000000222200002222002222222
200222200220000222200002200002
200222200220000222200002200002
200222200220022220000000000002
200222200220022220000000000002
222220000000000222200222222222
222220000000000222200222222222
222222200222222222200222222222
222222200222222222200222222222
200000000000000000000000000002
200000000080000000000000000002
222222222220022222222222222222
222222222220022222222222222222
222000022220000002222222222222
222070022220000002222222222222
222220000002200000000000000002
222220000002200000000000000002
200000022002222222200222200002
200000022002222222200222200002
200222222002222220000222222222
200222222002222220000222222222
200002222000000000000000022222
200002222000000000000060022222
200002200222222222222220000002
240002200222222222222220000032
222222222222222222222222222222
