222222222222222222222222222222
200000022220000002222222222002
200000022220000002222222222502
200222222000022000000000000002
200222222000022000000080000002
200222222002222222222222200222
200222222002222222222222200222
200220000000000220000222200222
200220000000000220000222200222
200222200222200000022222222002
200222200222200000622222222002
200220000002222000000000000222
200220000402222000000000000222
200222222002222002222222200222
200222222002222002222222200222
200222222002222002222222200222
200222222002222002222222200222
200000000222222220000000000222
200000000222222220000000000222
200222200220000000000002200222
200222200220007000000002200222
200222200220022222200222222222
200222200220022222200222222222
200222200000022220000000022002
200222200000022220000000022002
200222222220022220022222222002
200222222220022220022222222002
200000022220022220000000000002
200000022220022220000000000032
222222222222222222222222222222
