222222222222222222222222222222
200000000000000220022002222222
200000000000000220022002222222
200220022222200222222000000002
200220022222200222222000040002
200220022222200000000000022002
200220022222200000000000022002
222222222002222222222002222002
222222222002222222222002222002
222002222000000222200002222222
222002222000000222200002222222
222002200222200220000002200222
222082200222200220000002200222
222002222220000220022000000222
222002222220000220022000000222
200000000000000000022002222002
200000000060000000022002222002
200222222222222220022002222002
200222222222222220022002222002
200000000220000002222002200222
200000000220000002222002200222
200222200220000002200002200222
200222200220700002200002200222
222222200222222222200222200222
222222200222222222200222200222
222000000000000002200000000002
222000000500000002200000000002
200222222222222222200222222002
200222222222222222200222222032
222222222222222222222222222222
