222222222222222222222222222222
200222200000022222222222200002
200222200000022222222222200002
200002200220022000000000022222
200082200220022000000000022222
200000000222222002222220000002
200000000222222002222220000002
200220022222222002222000022002
200220022222222002222000022002
222220022000000002222002222222
222220022000000002222002222222
222220022220022002222000000222
222220022220022002222000000222
200000000000022002222002200222
200000000000022002222002200222
200222222222222222200002222222
200222222222222222200002222222
222000022222200222200000000002
222000022222200222200000000002
222222200000000000000222200002
222222200000600000000222200002
200002200222222002222002222222
200072200222222002222002222222
200000000220022002222002222222
200000000220022002222402222222
200220000220022000000000000002
200225000220022000000000000002
200222200220000222222222222002
200222200220000222222222222032
222222222222222222222222222222
