222222222222222222222222222222
200000000002222220022222222222
200000000002222220022222222222
200002222002200220000000000002
200002222002200220000000000002
222002222002200222200220022002
222002222002200222200220022002
222002222000000002200222222222
222002222000000002200222222222
200000000222222000000222200222
200000000222222000800222200222
200002200002222222200220000222
200002200502222222200220000222
200222222222200222200220022222
200222222222200222200220022222
200000000220000222200000000002
200000000220000222200000000002
200222222220022220000222222002
200222222220022220000222222002
200002222220022220000222222002
200002222220622220000222222002
222222200220022220022220000002
222222207220022220022220000002
222222200220022220022222222222
222222200220022220022222222222
200000000000000000000000022222
200000040000000000000000022222
200222200000022222222000000002
200222200000022222222000000032
222222222222222222222222222222
