222222222222222222222222222222
200000022000000220022220022002
200000022000000220022220022002
200220022222222220000000022222
250220022222222220000080022222
222220022000000222222000000002
222220022000000222222000000062
222000022002200000000002200222
222000022002200000000002200222
222000000002222220022222200222
222000000002222220022222200222
222002222002222220000222200222
222002222002222220000222200222
222002222000000002222222200002
222002222000000002222222200002
222002200002222222222000000002
222002200002222222222000000002
222002222222200220022002222222
222002222222200220022002222222
222002222220022220000000000002
222002222220022220000000000002
222002200220000222222002222002
222002200220000222222002222072
200000000000000222200002222002
200000000000000222200002222002
200220022222222222200222200002
200220022222222222200222200002
222220000222200000000222200002
222220000222200004000222200032
222222222222222222222222222222
