222222222222222222222222222222
200222222222222000000220000002
200222222222222000000220000002
200000000000000002200222222002
200000000000000002200222222002
222002222000022222200220000222
222002222000022222200220000222
222000022220000002222220022222
222000022220000002222220022222
222002222000022222200000000002
222002222000022222200060000002
222002222000022222200222222222
222002222000022222200222222222
222002222222222000000222222222
222002222222222000700222222222
222000000220022002200000000002
222005000220022002200000000002
200000022222222222200220022222
200000022222222222200220022222
200000000000000222200220022222
200000000000000222200220022222
200220000000000222200220000002
200220000000000222200220000402
200222222222200222200222222002
200222222222200222200222222082
222222222222200000000220022002
222222222222200000000220022002
222000000000000222222000022002
222000000000000222222000022032
222222222222222222222222222222
