222222222222222222222222222222
200002222000000000000000000222
200002222000000000000000000222
222002200000000000022222222222
222002200000000000022222222222
222000000220022220022222222002
222000000220022220022222222002
222002222220022220022000000002
222002222220022220022000008002
222000022220022222222002200002
222000022220022222222002200002
222000022220000002222222222002
222000022220000002222222222002
222000022222222000000220022002
222000022222222500000220022002
222220000002200000000000000002
222220007002200000000000000002
200222200222200220022222200222
240222200222200220622222200222
200222200222200220000002200222
200222200222200220000002200222
200002222220000222222222200222
200002222220000222222222200222
200000022220022222222222200222
200000022220022222222222200222
200220000000022000000000000222
200220000000022000000000000222
222220022220022222222222200002
222220022220022222222222200032
222222222222222222222222222222
