222222222222222222222222222222
200002222000000220022222200222
200002222400000220022222200222
222002222002222222200002200222
222002222002222222200002200222
222002222002222000000000000222
222002222002222000000000000222
222002200002200002200220000222
222002200002200002200220000222
222000000000000222200220022222
222000000000000222200220022222
200222200002222222222220000002
200222200002222222222220000002
222222200222222000022222200222
222222200222222000022222200222
200000000000000002222002222222
200000000500000002222002222222
200222222220022222222002222002
200222222220622222222002222002
200220022000000000000002222002
200220022000000000000002222002
222222200222200222222000000002
222222200222207222222000000002
222000022222200000022220022002
222000022222200000022220022002
222002222002222220022002222002
222002222002222220822002222002
222000000000000000022000022002
222000000000000000022000022032
222222222222222222222222222222
