222222222222222222222222222222
200000000000022220000002222002
200000000000022220000502222002
200222222220022222222002200222
200222222220022222222002200222
200222222220022002222002200222
200222222220022072222002200222
222220000000000002222002200222
222220000000000002222002200222
200220000222222002200002200222
200220000222222002200002200222
200220022220000000000220000222
200220022220000000000220000222
222222200222222220000222200222
222222200222222220000222200222
200002222002200220022220000222
200002222002206220022220000222
200222200000000000000222200222
200222200000000000000222200222
200000000222222000000002200222
200000800222222000000002200222
222222200002222222222000000002
222222200002222222222000000002
222222222002200222222222222002
222222222002200222222222222002
200000000002200000000220022002
200400000002200000000220022002
222222222000000222200002222002
222222222000000222200002222032
222222222222222222222222222222
