222222222222222222222222222222
200000000220000220022000022002
200000000220000220022000022002
222002222222222220022002222222
222002222222222220022002222222
222002222000000220000000000002
222062222000000220000000000002
222002222002200000022220022222
222002222002200000022220022222
222002222222200222222220022222
222002222222200222222220022222
222000000000000000000220000002
222000000000000000000220000002
200220000002222222222220022222
200220000002222222222220022222
200220022000022222222000000222
200220022000022222222000700222
200222222220022000000002222222
200222222220022000000002222222
222000000000022220022002222002
222000000000022220022002222002
222002222222200000022000022002
222002222222200000022000022002
222002222002200220000220000002
222502222002200220000220000002
222002222000000222200222222002
222002222000800222200222222002
222002222000000222200220022002
222002222000000222240220022032
222222222222222222222222222222
